TGTAGCGCTGCCATCCCAT -> GTAGCGCTGCCATCCCATA
CTAGTCTCACTTGTTAGCT -> TAGTCTCACTTGTTAGCTT
ATCCACGGAGATCGTTGGA -> TCCACGGAGATCGTTGGAC
AAATATTGATTCTAGTGCC -> AATATTGATTCTAGTGCCA
TGGGTGTAGTGGCACACGT -> GGGTGTAGTGGCACACGTG
CCAGGCACTATACCTGAAT -> CAGGCACTATACCTGAATC
GGTGTAGCGCTGCCATCCC -> GTGTAGCGCTGCCATCCCA
TTTTTATATAATCCCTCCC -> TTTTATATAATCCCTCCCT
GGTGTAGTGGCACACGTGG -> GTGTAGTGGCACACGTGGA
GGACTGGTCGTGGCGCCCC -> GACTGGTCGTGGCGCCCCG
TAGAAATATTGATTCTAGT -> AGAAATATTGATTCTAGTG
GAGGTCATGCGATCCCGGA -> AGGTCATGCGATCCCGGAC
AATGCCATTTTAGAGTCAC -> ATGCCATTTTAGAGTCACT
GACAAATCACATTACTGAG -> ACAAATCACATTACTGAGA
ATGGGATGGTAAAGTTTAA -> TGGGATGGTAAAGTTTAAT
CAACTTGACGAGCTTAACA -> AACTTGACGAGCTTAACAC
ATAGAAGTGGATTGCGGAT -> TAGAAGTGGATTGCGGATG
AATTTTTGTGTAGATCGGC -> ATTTTTGTGTAGATCGGCG
AGCCGGACCGGATCACGCG -> GCCGGACCGGATCACGCGT
ATTGGTTATAGAAACGGTA -> TTGGTTATAGAAACGGTAG
CGGCGGTAAAATGAACTCG -> GGCGGTAAAATGAACTCGT
ACACATCAGGCACTATACC -> CACATCAGGCACTATACCT
AATAACGGCCCATTCTCGT -> ATAACGGCCCATTCTCGTC
GCGTGGCTTTCTCAACGTA -> CGTGGCTTTCTCAACGTAC
AGTCCCCAGTGGATACGCG -> GTCCCCAGTGGATACGCGA
CATCAGGAGGGGCGGGTCA -> ATCAGGAGGGGCGGGTCAA
CGTGGTGTGGGCTCGATGC -> GTGGTGTGGGCTCGATGCG
GAGTTGGGTAGAAGCTATT -> AGTTGGGTAGAAGCTATTC
GTAGTGCGTAGTTTTTAGA -> TAGTGCGTAGTTTTTAGAC
AATCACATTACTGAGACGT -> ATCACATTACTGAGACGTG
TTTATCTGGATTTCTCCAT -> TTATCTGGATTTCTCCATG
TGTAGACTGCGCATTTATT -> GTAGACTGCGCATTTATTA
CACTCATACCGAGACAAAT -> ACTCATACCGAGACAAATC
GGATACGGGCAGATGCTAG -> GATACGGGCAGATGCTAGC
AGATGCTAGCACGTACATG -> GATGCTAGCACGTACATGC
AGTGATGACTTGTACTACC -> GTGATGACTTGTACTACCG
ACCACTCATAATATGCGGT -> CCACTCATAATATGCGGTT
GGTCACTGAATTTTTGTGT -> GTCACTGAATTTTTGTGTA
GCAGTAGCATTCACTTTAC -> CAGTAGCATTCACTTTACC
GGATGGTAAAGTTTAATGT -> GATGGTAAAGTTTAATGTT
ATAGGAGGGAACCGGCTAT -> TAGGAGGGAACCGGCTATT
ATGCCATTTTAGAGTCACT -> TGCCATTTTAGAGTCACTG
CTCTAGAACTAGTCCCCAG -> TCTAGAACTAGTCCCCAGT
ATACCTGAATCTAGTGCGG -> TACCTGAATCTAGTGCGGC
TATGCGGTTTTCTCGTAGG -> ATGCGGTTTTCTCGTAGGA
AGAATAAGACCACTCATAA -> GAATAAGACCACTCATAAT
TGGATTGCGGATGAGCAAG -> GGATTGCGGATGAGCAAGA
TGGTGGGTGTAGACTGCGC -> GGTGGGTGTAGACTGCGCA
GTTGAGCCGGACCGGATCA -> TTGAGCCGGACCGGATCAC
AATACCGTAAACTCTCTAG -> ATACCGTAAACTCTCTAGC
GTATGCCCTAGAAATATTG -> TATGCCCTAGAAATATTGA
TGGGTCGCCAACGATTGTA -> GGGTCGCCAACGATTGTAT
TCGTTTCCCTCGATCAATT -> CGTTTCCCTCGATCAATTT
AAGAATTAACGGGGATCTG -> AGAATTAACGGGGATCTGA
CACTAGGCGAACGCCCAGG -> ACTAGGCGAACGCCCAGGC
TGTGAAGTCGGTAATCCAC -> GTGAAGTCGGTAATCCACG
AGCCTCAGGATGCGTGCAG -> GCCTCAGGATGCGTGCAGT
CGCGATAATGCCATTTTAG -> GCGATAATGCCATTTTAGA
CACTTCCGCAGTCTCAACT -> ACTTCCGCAGTCTCAACTT
ATTGACCGAACTGTTTCCC -> TTGACCGAACTGTTTCCCT
CGTCGCCATGTTGCATTGG -> GTCGCCATGTTGCATTGGT
CTTTGCCCCATTTTGGGTC -> TTTGCCCCATTTTGGGTCA
GCTTAACACGTGGATCGAG -> CTTAACACGTGGATCGAGC
AGTGCCAGTGCCCAGATCG -> GTGCCAGTGCCCAGATCGG
TGCGGCTCTCGTCGTGGTG -> GCGGCTCTCGTCGTGGTGG
CGTCACACCGCCCTGCTGT -> GTCACACCGCCCTGCTGTT
CCCACTCCAGGCTGCTGGG -> CCACTCCAGGCTGCTGGGC
GCTAGTTCCTTTTCTATCG -> CTAGTTCCTTTTCTATCGC
TATTGTACGCCTGCTATAT -> ATTGTACGCCTGCTATATG
ATCCACGCGTCGCCATGTT -> TCCACGCGTCGCCATGTTG
AAATGAACTCGTGTGCGTT -> AATGAACTCGTGTGCGTTA
ACCGAAAGCACATCCACGG -> CCGAAAGCACATCCACGGA
GCGACAATTTGTGACCAAC -> CGACAATTTGTGACCAACA
CGTCGTGGTGGGTGTAGCG -> GTCGTGGTGGGTGTAGCGC
TGACCAACACACTAGTAGG -> GACCAACACACTAGTAGGC
CCCTGGAACCGATACTCAA -> CCTGGAACCGATACTCAAT
GAAGCAGCGCGTCTGACGC -> AAGCAGCGCGTCTGACGCT
CACATTACTGAGACGTGAT -> ACATTACTGAGACGTGATA
CGGTCATATCGTCACACCG -> GGTCATATCGTCACACCGC
ATCAGGAGGGGCGGGTCAA -> TCAGGAGGGGCGGGTCAAT
TCAGGAGGGGCGGGTCAAT -> CAGGAGGGGCGGGTCAATC
AGTCGGTAATCCACGCGTC -> GTCGGTAATCCACGCGTCG
TTCCCTCGATCAATTTTTG -> TCCCTCGATCAATTTTTGG
CGGTAGCACGAGACAGAAG -> GGTAGCACGAGACAGAAGT
GACCGAACTGTTTCCCTTT -> ACCGAACTGTTTCCCTTTG
CGTCCGGTATGCCCTAGAA -> GTCCGGTATGCCCTAGAAA
GTCTCAACTTGACGAGCTT -> TCTCAACTTGACGAGCTTA
GTAGAAGCTATTCCATAGG -> TAGAAGCTATTCCATAGGC
TGCGCGTGGTGTGGGCTCG -> GCGCGTGGTGTGGGCTCGA
CGGAAATCTCCCTCATCTA -> GGAAATCTCCCTCATCTAA
TACGAATTACTTGGTCGGT -> ACGAATTACTTGGTCGGTT
GTAGATCGGCGGTAAAATG -> TAGATCGGCGGTAAAATGA
TGTTAGCTTATCATAAGGA -> GTTAGCTTATCATAAGGAG
TGACTTGTACTACCGGATA -> GACTTGTACTACCGGATAT
GGTGTTATCTCGTCGTGGT -> GTGTTATCTCGTCGTGGTG
GATTGGCAGACGTCCGGTA -> ATTGGCAGACGTCCGGTAT
CGAATTACTTGGTCGGTTT -> GAATTACTTGGTCGGTTTC
AGGCACAGGCACTATACCT -> GGCACAGGCACTATACCTG
GGATGTTGAGTCAGTGCGT -> GATGTTGAGTCAGTGCGTG
TACGGTAACGCGATAATGC -> ACGGTAACGCGATAATGCC
CCGGACTGGTCGTGGCGCC -> CGGACTGGTCGTGGCGCCC
TGTAAATCCGTATTGTACG -> GTAAATCCGTATTGTACGC
CGTTATTATTGACGAGTCC -> GTTATTATTGACGAGTCCC
TCTACTGTCTTCGAAAGAC -> CTACTGTCTTCGAAAGACC
TCCCGGACTGGTCGTGGCG -> CCCGGACTGGTCGTGGCGC
CTATACCTGAATGATGGTG -> TATACCTGAATGATGGTGT
GCTCTCGTCGTGGTGGGTG -> CTCTCGTCGTGGTGGGTGT
CCTATCGAGAATGCCGCTC -> CTATCGAGAATGCCGCTCT
ACTAGGCGAACGCCCAGGC -> CTAGGCGAACGCCCAGGCA
GTGAAGGATCACCAACCAG -> TGAAGGATCACCAACCAGC
CCTGTGTGAAGTCGGTAAT -> CTGTGTGAAGTCGGTAATC
TTATCATAAGGAGTCCACT -> TATCATAAGGAGTCCACTC
CTGAGCCTCCACTCATCGA -> TGAGCCTCCACTCATCGAT
ATGCCCCCGCAACCATACG -> TGCCCCCGCAACCATACGT
CTCGTAGGAGGAATTGACC -> TCGTAGGAGGAATTGACCG
ACCAACACACTAGTAGGCA -> CCAACACACTAGTAGGCAC
CACATTCAATTATATTCTG -> ACATTCAATTATATTCTGC
AGTGGATACGCGAACGGGT -> GTGGATACGCGAACGGGTT
ACCAACGGCTGATCCGTTG -> CCAACGGCTGATCCGTTGT
ATCACCAACCAGCTTGCCA -> TCACCAACCAGCTTGCCAC
GGAGATCGTTGGACTCTTA -> GAGATCGTTGGACTCTTAT
GATCGGCGGTAAAATGAAC -> ATCGGCGGTAAAATGAACT
ACTTTCGAATTGTATGCCC -> CTTTCGAATTGTATGCCCC
ATAATGCCATTTTAGAGTC -> TAATGCCATTTTAGAGTCA
CGTCGTGGTGGGTGTAGAC -> GTCGTGGTGGGTGTAGACT
TAATCCACGCGTCGCCATG -> AATCCACGCGTCGCCATGT
TGATGACTTGTACTACCGG -> GATGACTTGTACTACCGGA
AGAAAATGCATTAAGGTCG -> GAAAATGCATTAAGGTCGC
ACGTGGATGACTATCTGTG -> CGTGGATGACTATCTGTGT
GTAATCCACGCGTCGCCAT -> TAATCCACGCGTCGCCATG
GTATTGTACGCCTGCTATA -> TATTGTACGCCTGCTATAT
CTGGAACCGATACTCAATA -> TGGAACCGATACTCAATAC
TTGTTAGCTTATCATAAGG -> TGTTAGCTTATCATAAGGA
GCATCAGGAGGGGCGGGTC -> CATCAGGAGGGGCGGGTCA
GGCTGCTGGGCACTCGTAG -> GCTGCTGGGCACTCGTAGC
GCTGGTGTAAATCCGTATT -> CTGGTGTAAATCCGTATTG
GCGAACGGGTCACTGAATT -> CGAACGGGTCACTGAATTT
ATATCTTACACATCAGGCA -> TATCTTACACATCAGGCAC
TGAGACGTGATACCATTCG -> GAGACGTGATACCATTCGC
CAGTCTACTGTCTTCGAAA -> AGTCTACTGTCTTCGAAAG
GGGTCATCCATTGGACTTT -> GGTCATCCATTGGACTTTC
CAGATGCTAGCACGTACAT -> AGATGCTAGCACGTACATG
GATCTGATTAGAGTGACTT -> ATCTGATTAGAGTGACTTT
TGACTATCTGTGTACCAAC -> GACTATCTGTGTACCAACC
GCAGGCACTATACCTGAAT -> CAGGCACTATACCTGAATG
GCTGATCCGTTGTCTCCCA -> CTGATCCGTTGTCTCCCAC
CCGTTCCGTTTCAGCCTGA -> CGTTCCGTTTCAGCCTGAA
ATTATTGACGAGTCCCAGG -> TTATTGACGAGTCCCAGGG
GTTCCGGGGATGTTGAGTC -> TTCCGGGGATGTTGAGTCA
AGTCCTGCGTTACTGCAGT -> GTCCTGCGTTACTGCAGTA
TTCGAAAGACCGTAATATC -> TCGAAAGACCGTAATATCT
GTCTTCGAAAGACCGTAAT -> TCTTCGAAAGACCGTAATA
TATGGGATGGTAAAGTTTA -> ATGGGATGGTAAAGTTTAA
CGTCTGACGCTGGTGTAAA -> GTCTGACGCTGGTGTAAAT
CGGCTCTCGTCGTGGTGGG -> GGCTCTCGTCGTGGTGGGT
AGACAGAAGTGGAGTTGGG -> GACAGAAGTGGAGTTGGGT
TTTACCAGAACGCACGTCG -> TTACCAGAACGCACGTCGC
TGGATTTCTCCATGCTTAC -> GGATTTCTCCATGCTTACA
CTCATACCGAGACAAATCA -> TCATACCGAGACAAATCAC
GAGCCTCCACTCATCGATA -> AGCCTCCACTCATCGATAG
CCGAACTGTTTCCCTTTGC -> CGAACTGTTTCCCTTTGCG
CGGTTTTCTCGTAGGAGGA -> GGTTTTCTCGTAGGAGGAA
TTTGTGTAGATCGGCGGTA -> TTGTGTAGATCGGCGGTAA
ACTTGTACTACCGGATATC -> CTTGTACTACCGGATATCT
TGCCTCGTTGAGCCGGACC -> GCCTCGTTGAGCCGGACCG
GAATTGTATGCCCCCGCAA -> AATTGTATGCCCCCGCAAC
TGCATTAAGGTCGCCGGGC -> GCATTAAGGTCGCCGGGCG
CCTGCTATATGGGTAGGAC -> CTGCTATATGGGTAGGACC
ATTACTGAGACGTGATACC -> TTACTGAGACGTGATACCA
GAGACAAATCACATTACTG -> AGACAAATCACATTACTGA
CGAACGCCCAGGCACTATA -> GAACGCCCAGGCACTATAC
AGGATGCGTGCAGTCTACT -> GGATGCGTGCAGTCTACTG
GTTCCTTTTCTATCGCTGT -> TTCCTTTTCTATCGCTGTT
CCATATACATAGGAGGGAA -> CATATACATAGGAGGGAAC
CGTGCAGTCTACTGTCTTC -> GTGCAGTCTACTGTCTTCG
ATACCGAGACAAATCACAT -> TACCGAGACAAATCACATT
CATAAAAACCCTGTGTGAA -> ATAAAAACCCTGTGTGAAG
CATAAGGAGTCCACTCATA -> ATAAGGAGTCCACTCATAC
GTAATATCTCGGAAATCTC -> TAATATCTCGGAAATCTCC
GTGGGTGTAGTGCGTAGTT -> TGGGTGTAGTGCGTAGTTT
AGTAGCATTCACTTTACCA -> GTAGCATTCACTTTACCAG
ATGCTTACACGGGAAGCGC -> TGCTTACACGGGAAGCGCG
CATGCTTACACGGGAAGCG -> ATGCTTACACGGGAAGCGC
TGCCGCTCTTGTGGTCGGC -> GCCGCTCTTGTGGTCGGCG
TCTCGTAGGAGGAATTGAC -> CTCGTAGGAGGAATTGACC
AGAAGTGGAGTTGGGTAGA -> GAAGTGGAGTTGGGTAGAA
TGTAGATCGGCGGTAAAAT -> GTAGATCGGCGGTAAAATG
CTTGACGAGCTTAACACGT -> TTGACGAGCTTAACACGTG
TTACTTGGTCGGTTTCGTG -> TACTTGGTCGGTTTCGTGC
AAGACCACTCATAATATGC -> AGACCACTCATAATATGCG
TAAAGTTTAATGTTCCATA -> AAAGTTTAATGTTCCATAC
CACTTGTTAGCTTATCATA -> ACTTGTTAGCTTATCATAA
ACTTGTTAGCTTATCATAA -> CTTGTTAGCTTATCATAAG
TCACTTCCGCAGTCTCAAC -> CACTTCCGCAGTCTCAACT
CAGTGGATACGCGAACGGG -> AGTGGATACGCGAACGGGT
GCTATATGGGTAGGACCCC -> CTATATGGGTAGGACCCCC
CACAACACGGATGCCGCAG -> ACAACACGGATGCCGCAGC
GCCCAGGCACTATACCTGA -> CCCAGGCACTATACCTGAA
TAGACTGCGCATTTATTAC -> AGACTGCGCATTTATTACG
GTAGTTTTTAGACGACACA -> TAGTTTTTAGACGACACAC
TAAAAACCCTGTGTGAAGT -> AAAAACCCTGTGTGAAGTC
GTGGGTGTAGTGGCACACG -> TGGGTGTAGTGGCACACGT
TGAATGGGAGCATCAGGAG -> GAATGGGAGCATCAGGAGG
TTTTGGGTGGGCTTTGCCT -> TTTGGGTGGGCTTTGCCTC
CTCTGTCCATCCTTGGCTA -> TCTGTCCATCCTTGGCTAC
ATGCCGCAGCGAGGTCATG -> TGCCGCAGCGAGGTCATGC
TTCTAGTGCCAGTGCCCAG -> TCTAGTGCCAGTGCCCAGA
GGGAGCATCAGGAGGGGCG -> GGAGCATCAGGAGGGGCGG
TCGAGTAGGTAGTGATGAC -> CGAGTAGGTAGTGATGACT
CGAACGGGTTAATACCGTA -> GAACGGGTTAATACCGTAA
GACTTGTACTACCGGATAT -> ACTTGTACTACCGGATATC
AAGGATCACCAACCAGCTT -> AGGATCACCAACCAGCTTG
TACTTGGTCGGTTTCGTGC -> ACTTGGTCGGTTTCGTGCC
CTGTGTACCAACCGAAAGC -> TGTGTACCAACCGAAAGCA
GGGTAGAAGCTATTCCATA -> GGTAGAAGCTATTCCATAG
CACATCAGGCACTATACCT -> ACATCAGGCACTATACCTG
GGACCGGATCACGCGTAGA -> GACCGGATCACGCGTAGAC
GCTGCTGGGCACTCGTAGC -> CTGCTGGGCACTCGTAGCC
ATCGATAGGATACGGGCAG -> TCGATAGGATACGGGCAGA
GTACTACCGGATATCTTAC -> TACTACCGGATATCTTACA
TTCGTCGGTCATATCGTCA -> TCGTCGGTCATATCGTCAC
TAAAATGAACTCGTGTGCG -> AAAATGAACTCGTGTGCGT
GCCCTGCTGTTCCGGGGAT -> CCCTGCTGTTCCGGGGATG
AATGTTCCATACGCAGTGG -> ATGTTCCATACGCAGTGGG
TCTAGTGCCAGTGCCCAGA -> CTAGTGCCAGTGCCCAGAT
CGTGCCACTAGGCGAACGC -> GTGCCACTAGGCGAACGCC
ACCGGATATCTTACACATC -> CCGGATATCTTACACATCA
TAGTTTTTAGACGACACAC -> AGTTTTTAGACGACACACA
CGATAATGCCATTTTAGAG -> GATAATGCCATTTTAGAGT
ATGCGTGCAGTCTACTGTC -> TGCGTGCAGTCTACTGTCT
TATCTAAGCGAACGAGTGG -> ATCTAAGCGAACGAGTGGG
CTGCTCTAGAACTAGTCCC -> TGCTCTAGAACTAGTCCCC
CTCAATACCAGCCTAATAC -> TCAATACCAGCCTAATACG
TCCTTGGCTACGAAGCAGC -> CCTTGGCTACGAAGCAGCG
TGGCTCTGTCCATCCTTGG -> GGCTCTGTCCATCCTTGGC
ATCCCGGACTGGTCGTGGC -> TCCCGGACTGGTCGTGGCG
GTCCCCAGTGGATACGCGA -> TCCCCAGTGGATACGCGAA
TAAGCGAACGAGTGGGTGC -> AAGCGAACGAGTGGGTGCA
TTTCCCTTTGCGACAATTT -> TTCCCTTTGCGACAATTTG
GTCGGTCATATCGTCACAC -> TCGGTCATATCGTCACACC
GTTACTGCAGTAGCATTCA -> TTACTGCAGTAGCATTCAC
CGGACTGGTCGTGGCGCCC -> GGACTGGTCGTGGCGCCCC
GAGCTTAACACGTGGATCG -> AGCTTAACACGTGGATCGA
TTGGCAGACGTCCGGTATG -> TGGCAGACGTCCGGTATGC
ACGTGAAGGATCACCAACC -> CGTGAAGGATCACCAACCA
TTTTGTGTAGATCGGCGGT -> TTTGTGTAGATCGGCGGTA
TGGAGAATCCAGTATCTGA -> GGAGAATCCAGTATCTGAG
ACCGATACTCAATACCAGC -> CCGATACTCAATACCAGCC
AGTCTTAAAGCCTAATGGG -> GTCTTAAAGCCTAATGGGT
ATGTTCCATACGCAGTGGG -> TGTTCCATACGCAGTGGGG
TACCAACCGAAAGCACATC -> ACCAACCGAAAGCACATCC
GAACTGTTTCCCTTTGCGA -> AACTGTTTCCCTTTGCGAC
GGGTCACTGAATTTTTGTG -> GGTCACTGAATTTTTGTGT
TCCGTTGTCTCCCACTCCA -> CCGTTGTCTCCCACTCCAG
AACACACTAGTAGGCACAG -> ACACACTAGTAGGCACAGG
GAGATCGTTGGACTCTTAT -> AGATCGTTGGACTCTTATG
CTTTGCGACAATTTGTGAC -> TTTGCGACAATTTGTGACC
ATTTTTGTGTAGATCGGCG -> TTTTTGTGTAGATCGGCGG
ATCTGGATTTCTCCATGCT -> TCTGGATTTCTCCATGCTT
AGAACGCACGTCGCACATT -> GAACGCACGTCGCACATTC
CGCGAACGGGTTAATACCG -> GCGAACGGGTTAATACCGT
CTCACGCGAACGGGTCACT -> TCACGCGAACGGGTCACTG
CGGTATGCCCTAGAAATAT -> GGTATGCCCTAGAAATATT
GAGAATCCAGTATCTGAGC -> AGAATCCAGTATCTGAGCC
ACGGGGATCTGATTAGAGT -> CGGGGATCTGATTAGAGTG
ATCCAGTATCTGAGCCTCC -> TCCAGTATCTGAGCCTCCA
GCTGCGATGCCTAAGAATT -> CTGCGATGCCTAAGAATTA
GAAACGGTAGCACGAGACA -> AAACGGTAGCACGAGACAG
CTGATACGTGAAGGATCAC -> TGATACGTGAAGGATCACC
CTAAGCGAACGAGTGGGTG -> TAAGCGAACGAGTGGGTGC
AAGGTCAGCGTGCCACTAG -> AGGTCAGCGTGCCACTAGG
GAGCAAGAAAATGCATTAA -> AGCAAGAAAATGCATTAAG
TTGAGCCGGACCGGATCAC -> TGAGCCGGACCGGATCACG
TGCAGGCACTATACCTGAA -> GCAGGCACTATACCTGAAT
TGGGTCATCCATTGGACTT -> GGGTCATCCATTGGACTTT
TCTGATTAGAGTGACTTTG -> CTGATTAGAGTGACTTTGG
AAGCGAACGAGTGGGTGCA -> AGCGAACGAGTGGGTGCAG
ATTCTGCTCTAGAACTAGT -> TTCTGCTCTAGAACTAGTC
GGTGTAAATCCGTATTGTA -> GTGTAAATCCGTATTGTAC
CTCACTTGTTAGCTTATCA -> TCACTTGTTAGCTTATCAT
GTAGACTGCGCATTTATTA -> TAGACTGCGCATTTATTAC
ACCCGGCTAGTTCCTTTTC -> CCCGGCTAGTTCCTTTTCT
AGCACGTACATGCGCGTGG -> GCACGTACATGCGCGTGGT
TTTTCTATCGCTGTTCGCC -> TTTCTATCGCTGTTCGCCG
CCGCAACCATACGTCGTTT -> CGCAACCATACGTCGTTTC
ATCTCGGAAATCTCCCTCA -> TCTCGGAAATCTCCCTCAT
CAGTCTTAAAGCCTAATGG -> AGTCTTAAAGCCTAATGGG
GACCTATGGCGTCTCAGTC -> ACCTATGGCGTCTCAGTCT
GTCGTGGCGCCCCGGGTGT -> TCGTGGCGCCCCGGGTGTC
TGCAGTAGCATTCACTTTA -> GCAGTAGCATTCACTTTAC
CGTAGGAGGAATTGACCGA -> GTAGGAGGAATTGACCGAA
ATGCCGCTCTTGTGGTCGG -> TGCCGCTCTTGTGGTCGGC
CGCGTAGACCAACGGCTGA -> GCGTAGACCAACGGCTGAT
AGCACAGAATAAGACCACT -> GCACAGAATAAGACCACTC
TGGTCGGCGGCACGCGGGG -> GGTCGGCGGCACGCGGGGA
CTCGGTTCGTCGGTCATAT -> TCGGTTCGTCGGTCATATC
GACGTCCGGTATGCCCTAG -> ACGTCCGGTATGCCCTAGA
GAACTCGTGTGCGTTATTA -> AACTCGTGTGCGTTATTAT
GGTCATCCATTGGACTTTC -> GTCATCCATTGGACTTTCG
CATTGGACTTTCGAATTGT -> ATTGGACTTTCGAATTGTA
GATCAATTTTTGGGTGGGC -> ATCAATTTTTGGGTGGGCT
GAATCTAGTGCGGCTCTCG -> AATCTAGTGCGGCTCTCGT
CGTGATTGGCAGACGTCCG -> GTGATTGGCAGACGTCCGG
GTGCGTAGTTTTTAGACGA -> TGCGTAGTTTTTAGACGAC
TCCGTTTCAGCCTGAATGG -> CCGTTTCAGCCTGAATGGG
ACTCTTATGCAGCTTTGCC -> CTCTTATGCAGCTTTGCCC
GGATACGCGAACGGGTTAA -> GATACGCGAACGGGTTAAT
TAGCGACTGCCGACAATAC -> AGCGACTGCCGACAATACG
TAGACCAACGGCTGATCCG -> AGACCAACGGCTGATCCGT
GTTATTATTGACGAGTCCC -> TTATTATTGACGAGTCCCA
GACGCTGGTGTAAATCCGT -> ACGCTGGTGTAAATCCGTA
TGTCTTCGAAAGACCGTAA -> GTCTTCGAAAGACCGTAAT
GTCGCCAACGATTGTATGG -> TCGCCAACGATTGTATGGG
CAGCGTGGCTTTCTCAACG -> AGCGTGGCTTTCTCAACGT
GAGACAGAAGTGGAGTTGG -> AGACAGAAGTGGAGTTGGG
CCTAAGAATTAACGGGGAT -> CTAAGAATTAACGGGGATC
AACGAGTGGGTGCAGGCAC -> ACGAGTGGGTGCAGGCACT
GGATTGCGGATGAGCAAGA -> GATTGCGGATGAGCAAGAA
CAACGGCTGATCCGTTGTC -> AACGGCTGATCCGTTGTCT
GTGTCGCGAACGTGGAGAA -> TGTCGCGAACGTGGAGAAT
CGGAGATCGTTGGACTCTT -> GGAGATCGTTGGACTCTTA
TTATCTCGTCGTGGTGGGT -> TATCTCGTCGTGGTGGGTG
ACGTCGCACATTCAATTAT -> CGTCGCACATTCAATTATA
TACGGGCAGATGCTAGCAC -> ACGGGCAGATGCTAGCACG
GAACGCACGTCGCACATTC -> AACGCACGTCGCACATTCA
CAATACGAATTACTTGGTC -> AATACGAATTACTTGGTCG
GAATAACGGCCCATTCTCG -> AATAACGGCCCATTCTCGT
AATACGTTGGACCCTATCG -> ATACGTTGGACCCTATCGA
GGTAGCACGAGACAGAAGT -> GTAGCACGAGACAGAAGTG
ATCTTACACATCAGGCACT -> TCTTACACATCAGGCACTA
AATGGGTCGCCAACGATTG -> ATGGGTCGCCAACGATTGT
TCGTAGGAGGAATTGACCG -> CGTAGGAGGAATTGACCGA
ACGTTGGACCCTATCGAGA -> CGTTGGACCCTATCGAGAA
CGGATATCTTACACATCAG -> GGATATCTTACACATCAGG
AACGGTAGCACGAGACAGA -> ACGGTAGCACGAGACAGAA
TGGCACACGTGGATGACTA -> GGCACACGTGGATGACTAT
GGATCTGATTAGAGTGACT -> GATCTGATTAGAGTGACTT
TCATAAGCATAAAAACCCT -> CATAAGCATAAAAACCCTG
CCAACGATTGTATGGGATG -> CAACGATTGTATGGGATGG
TAGTGCCAGTGCCCAGATC -> AGTGCCAGTGCCCAGATCG
CGTAGCCCTGGAACCGATA -> GTAGCCCTGGAACCGATAC
TGGTTATAGAAACGGTAGC -> GGTTATAGAAACGGTAGCA
GTGGATTGCGGATGAGCAA -> TGGATTGCGGATGAGCAAG
TTCACTTTACCAGAACGCA -> TCACTTTACCAGAACGCAC
GTGGGCTCGATGCGCAGCG -> TGGGCTCGATGCGCAGCGT
CGCTCTTGTGGTCGGCGGC -> GCTCTTGTGGTCGGCGGCA
TATACCTGAATGATGGTGT -> ATACCTGAATGATGGTGTT
GGATGCGTGCAGTCTACTG -> GATGCGTGCAGTCTACTGT
TATATTCTGCTCTAGAACT -> ATATTCTGCTCTAGAACTA
CACACTAGTAGGCACAGGC -> ACACTAGTAGGCACAGGCA
ACCCTATCGAGAATGCCGC -> CCCTATCGAGAATGCCGCT
GTTTCAGCCTGAATGGGAG -> TTTCAGCCTGAATGGGAGC
TGCGCATTTATTACGGTAA -> GCGCATTTATTACGGTAAC
GGCTCACGCGAACGGGTCA -> GCTCACGCGAACGGGTCAC
ATTGGCAGACGTCCGGTAT -> TTGGCAGACGTCCGGTATG
TGCAGCTTTGCCCCATTTT -> GCAGCTTTGCCCCATTTTG
TTGGACTCTTATGCAGCTT -> TGGACTCTTATGCAGCTTT
TCGGCGGTAAAATGAACTC -> CGGCGGTAAAATGAACTCG
AGGCACTATACCTGAATCT -> GGCACTATACCTGAATCTA
AGCAGCGCGTCTGACGCTG -> GCAGCGCGTCTGACGCTGG
CGGGCGATGGCTCTGTCCA -> GGGCGATGGCTCTGTCCAT
ACATCAGGCACTATACCTG -> CATCAGGCACTATACCTGA
TCATCTAACTTTATCTGGA -> CATCTAACTTTATCTGGAT
TACGCAGTGGGGCGGTATC -> ACGCAGTGGGGCGGTATCT
AGTCCACTCATACCGAGAC -> GTCCACTCATACCGAGACA
TCGCGTTTTTTATATAATC -> CGCGTTTTTTATATAATCC
CATAATATGCGGTTTTCTC -> ATAATATGCGGTTTTCTCG
GAGGGGCGGGTCAATCAGC -> AGGGGCGGGTCAATCAGCA
TAGCATTCACTTTACCAGA -> AGCATTCACTTTACCAGAA
GTCAATCAGCACGTCTCGC -> TCAATCAGCACGTCTCGCG
CCCCCGCAACCATACGTCG -> CCCCGCAACCATACGTCGT
TCAGTCTTAAAGCCTAATG -> CAGTCTTAAAGCCTAATGG
TTATATAATCCCTCCCTCA -> TATATAATCCCTCCCTCAC
TTTTTTATATAATCCCTCC -> TTTTTATATAATCCCTCCC
AGGCACTATACCTGAATAA -> GGCACTATACCTGAATAAC
GAGCCGGACCGGATCACGC -> AGCCGGACCGGATCACGCG
ATCAGCACGTCTCGCGTTT -> TCAGCACGTCTCGCGTTTT
CCGAAAGCACATCCACGGA -> CGAAAGCACATCCACGGAG
GAGTCACTGGTTAGCGCTT -> AGTCACTGGTTAGCGCTTC
TTATATTCTGCTCTAGAAC -> TATATTCTGCTCTAGAACT
AGCACGTCTCGCGTTTTTT -> GCACGTCTCGCGTTTTTTA
TTGGCTACGAAGCAGCGCG -> TGGCTACGAAGCAGCGCGT
ACTGCAGTAGCATTCACTT -> CTGCAGTAGCATTCACTTT
CGTAAACTCTCTAGCGACT -> GTAAACTCTCTAGCGACTG
CCATTCGCCGCACTGATAC -> CATTCGCCGCACTGATACG
GGAGAATCCAGTATCTGAG -> GAGAATCCAGTATCTGAGC
ACTACCGGATATCTTACAC -> CTACCGGATATCTTACACA
TCATAAGGAGTCCACTCAT -> CATAAGGAGTCCACTCATA
GCCTCCACTCATCGATAGG -> CCTCCACTCATCGATAGGA
GCACTATACCTGAATTGGA -> CACTATACCTGAATTGGAA
GCGTAGTTTTTAGACGACA -> CGTAGTTTTTAGACGACAC
GGTGGGCTTTGCCTCGTTG -> GTGGGCTTTGCCTCGTTGA
CTCGTCGTGGTGGGTGTAG -> TCGTCGTGGTGGGTGTAGT,TCGTCGTGGTGGGTGTAGA,TCGTCGTGGTGGGTGTAGT,TCGTCGTGGTGGGTGTAGC
TGGTGGGTGTAGCGCTGCC -> GGTGGGTGTAGCGCTGCCA
GGAGTTGGGTAGAAGCTAT -> GAGTTGGGTAGAAGCTATT
TCACTGAATTTTTGTGTAG -> CACTGAATTTTTGTGTAGA
TTACCAGAACGCACGTCGC -> TACCAGAACGCACGTCGCA
AAAACCCTGTGTGAAGTCG -> AAACCCTGTGTGAAGTCGG
CACTATACCTGAATCTAGT -> ACTATACCTGAATCTAGTG
CATTCACTTTACCAGAACG -> ATTCACTTTACCAGAACGC
CGCCGCACTGATACGTGAA -> GCCGCACTGATACGTGAAG
CACAAGGTCAGCGTGCCAC -> ACAAGGTCAGCGTGCCACT
ATAATCCCTCCCTCACTTC -> TAATCCCTCCCTCACTTCC
AGCTATTCCATAGGCTCCA -> GCTATTCCATAGGCTCCAG
TAATACGTTGGACCCTATC -> AATACGTTGGACCCTATCG
ATTGCGGATGAGCAAGAAA -> TTGCGGATGAGCAAGAAAA
CGGGTCACTGAATTTTTGT -> GGGTCACTGAATTTTTGTG
AGAATCCAGTATCTGAGCC -> GAATCCAGTATCTGAGCCT
ACGATTGTATGGGATGGTA -> CGATTGTATGGGATGGTAA
CCTAGTCTCACTTGTTAGC -> CTAGTCTCACTTGTTAGCT
GTAGTGATGACTTGTACTA -> TAGTGATGACTTGTACTAC
CCGTTGTCTCCCACTCCAG -> CGTTGTCTCCCACTCCAGG
AACACGTGGATCGAGCCTC -> ACACGTGGATCGAGCCTCA
AATACCCGGCTAGTTCCTT -> ATACCCGGCTAGTTCCTTT
GAGCATCAGGAGGGGCGGG -> AGCATCAGGAGGGGCGGGT
CGTTAGTAGCACAGAATAA -> GTTAGTAGCACAGAATAAG
TACCGTAAACTCTCTAGCG -> ACCGTAAACTCTCTAGCGA
GTGGATGACTATCTGTGTA -> TGGATGACTATCTGTGTAC
TGTGCGTTATTATTGACGA -> GTGCGTTATTATTGACGAG
TATCTCGGAAATCTCCCTC -> ATCTCGGAAATCTCCCTCA
GCGTGCCACTAGGCGAACG -> CGTGCCACTAGGCGAACGC
GTGGGTGCAGGCACTATAC -> TGGGTGCAGGCACTATACC
CCCCAGTGGATACGCGAAC -> CCCAGTGGATACGCGAACG
TCACACCGCCCTGCTGTTC -> CACACCGCCCTGCTGTTCC
ACATAGGAGGGAACCGGCT -> CATAGGAGGGAACCGGCTA
TTAGTAGCACAGAATAAGA -> TAGTAGCACAGAATAAGAC
CATTAAGGTCGCCGGGCGA -> ATTAAGGTCGCCGGGCGAT
CACGTACATGCGCGTGGTG -> ACGTACATGCGCGTGGTGT
TGCTTACACGGGAAGCGCG -> GCTTACACGGGAAGCGCGT
GGATGCCGCAGCGAGGTCA -> GATGCCGCAGCGAGGTCAT
TCCGTATTGTACGCCTGCT -> CCGTATTGTACGCCTGCTA
CGGATGCCGCAGCGAGGTC -> GGATGCCGCAGCGAGGTCA
AGAAGTGGATTGCGGATGA -> GAAGTGGATTGCGGATGAG
GTTGGACCCTATCGAGAAT -> TTGGACCCTATCGAGAATG
TCTTGTGGTCGGCGGCACG -> CTTGTGGTCGGCGGCACGC
CACGCGCTGCGATGCCTAA -> ACGCGCTGCGATGCCTAAG
CATCCACGGAGATCGTTGG -> ATCCACGGAGATCGTTGGA
GGATCACCAACCAGCTTGC -> GATCACCAACCAGCTTGCC
TTCGCCGGTCTTGCACAAG -> TCGCCGGTCTTGCACAAGG
GTGTAAATCCGTATTGTAC -> TGTAAATCCGTATTGTACG
TGACGAGCTTAACACGTGG -> GACGAGCTTAACACGTGGA
CCGGATATCTTACACATCA -> CGGATATCTTACACATCAG
TGGATGACTATCTGTGTAC -> GGATGACTATCTGTGTACC
GCGCATTTATTACGGTAAC -> CGCATTTATTACGGTAACG
ACGCGATAATGCCATTTTA -> CGCGATAATGCCATTTTAG
TCCATAGGCTCCAGAACAC -> CCATAGGCTCCAGAACACG
GGGAGCGTAGTCCTGCGTT -> GGAGCGTAGTCCTGCGTTA
CTCTAGCGACTGCCGACAA -> TCTAGCGACTGCCGACAAT
AAAGACCGTAATATCTCGG -> AAGACCGTAATATCTCGGA
CCGTATTGTACGCCTGCTA -> CGTATTGTACGCCTGCTAT
ATCTCGTCGTGGTGGGTGT -> TCTCGTCGTGGTGGGTGTA
CCCGCAACCATACGTCGTT -> CCGCAACCATACGTCGTTT
TGGCAGACGTCCGGTATGC -> GGCAGACGTCCGGTATGCC
TCTATCGCTGTTCGCCGGT -> CTATCGCTGTTCGCCGGTC
TCCCTCACTTCCGCAGTCT -> CCCTCACTTCCGCAGTCTC
AATGAAACCTCGTCGTGGT -> ATGAAACCTCGTCGTGGTG
GGCTCCAGAACACGCGCTG -> GCTCCAGAACACGCGCTGC
ATGCGCAGCGTGGCTTTCT -> TGCGCAGCGTGGCTTTCTC
CGACAATACGAATTACTTG -> GACAATACGAATTACTTGG
TACACGGGAAGCGCGTTAG -> ACACGGGAAGCGCGTTAGT
CATTTATTACGGTAACGCG -> ATTTATTACGGTAACGCGA
AGCTTGCCACTCGGTTCGT -> GCTTGCCACTCGGTTCGTC
ATCTAACTTTATCTGGATT -> TCTAACTTTATCTGGATTT
CCTCGTCGTGGTGGGTGTA -> CTCGTCGTGGTGGGTGTAG
TTAGACGACACACAACACG -> TAGACGACACACAACACGG
TTGGTTATAGAAACGGTAG -> TGGTTATAGAAACGGTAGC
TCAATTATATTCTGCTCTA -> CAATTATATTCTGCTCTAG
CTCATCTAACTTTATCTGG -> TCATCTAACTTTATCTGGA
TAGAAGTGGATTGCGGATG -> AGAAGTGGATTGCGGATGA
GATAGGATACGGGCAGATG -> ATAGGATACGGGCAGATGC
CGACTGCCGACAATACGAA -> GACTGCCGACAATACGAAT
GCTTTCTCAACGTACTTTA -> CTTTCTCAACGTACTTTAT
AGCCTAATGGGTCGCCAAC -> GCCTAATGGGTCGCCAACG
TATGCCCCCGCAACCATAC -> ATGCCCCCGCAACCATACG
CTGCAGTAGCATTCACTTT -> TGCAGTAGCATTCACTTTA
GGTAAAGTTTAATGTTCCA -> GTAAAGTTTAATGTTCCAT
TTTTGGGTCATCCATTGGA -> TTTGGGTCATCCATTGGAC
GGCTATTCGAGTAGGTAGT -> GCTATTCGAGTAGGTAGTG
GAGCCTCAGGATGCGTGCA -> AGCCTCAGGATGCGTGCAG
TGTACGCCTGCTATATGGG -> GTACGCCTGCTATATGGGT
CTTCCGTTCCGTTTCAGCC -> TTCCGTTCCGTTTCAGCCT
AGACCACTCATAATATGCG -> GACCACTCATAATATGCGG
GGCACTATACCTGAATCTA -> GCACTATACCTGAATCTAG
GAACACGCGCTGCGATGCC -> AACACGCGCTGCGATGCCT
CCGGGGATGTTGAGTCAGT -> CGGGGATGTTGAGTCAGTG
CACTCGTAGCCCTGGAACC -> ACTCGTAGCCCTGGAACCG
TTGACCGAACTGTTTCCCT -> TGACCGAACTGTTTCCCTT
CAGACGTCCGGTATGCCCT -> AGACGTCCGGTATGCCCTA
TTTATATAATCCCTCCCTC -> TTATATAATCCCTCCCTCA
GTCTGACGCTGGTGTAAAT -> TCTGACGCTGGTGTAAATC
TCCGTTCCGTTTCAGCCTG -> CCGTTCCGTTTCAGCCTGA
GTGGATACGCGAACGGGTT -> TGGATACGCGAACGGGTTA
CGAATTGTATGCCCCCGCA -> GAATTGTATGCCCCCGCAA
AAACCCATAGAAGTGGATT -> AACCCATAGAAGTGGATTG
GAATTAACGGGGATCTGAT -> AATTAACGGGGATCTGATT
ACTTTGGCTCACGCGAACG -> CTTTGGCTCACGCGAACGG
CGGCTAGTTCCTTTTCTAT -> GGCTAGTTCCTTTTCTATC
ACACGGGAAGCGCGTTAGT -> CACGGGAAGCGCGTTAGTA
GCTCCAGAACACGCGCTGC -> CTCCAGAACACGCGCTGCG
GGTATCTAAGCGAACGAGT -> GTATCTAAGCGAACGAGTG
TAGCACAGAATAAGACCAC -> AGCACAGAATAAGACCACT
GCAGTCTCAACTTGACGAG -> CAGTCTCAACTTGACGAGC
TTGCATTGGTTATAGAAAC -> TGCATTGGTTATAGAAACG
CTTTCTCAACGTACTTTAT -> TTTCTCAACGTACTTTATC
CTGATCCGTTGTCTCCCAC -> TGATCCGTTGTCTCCCACT
CACTCGGTTCGTCGGTCAT -> ACTCGGTTCGTCGGTCATA
GGTCGGTTTCGTGCCAAAC -> GTCGGTTTCGTGCCAAACC
GCGCTGCCATCCCATATAC -> CGCTGCCATCCCATATACA
CGTTGTCTCCCACTCCAGG -> GTTGTCTCCCACTCCAGGC
TCATATCGTCACACCGCCC -> CATATCGTCACACCGCCCT
CACTGATACGTGAAGGATC -> ACTGATACGTGAAGGATCA
CAAGGTCAGCGTGCCACTA -> AAGGTCAGCGTGCCACTAG
GTTCCGTTTCAGCCTGAAT -> TTCCGTTTCAGCCTGAATG
ACGGTAGCACGAGACAGAA -> CGGTAGCACGAGACAGAAG
GCAGCTTTGCCCCATTTTG -> CAGCTTTGCCCCATTTTGG
TCCACGGAGATCGTTGGAC -> CCACGGAGATCGTTGGACT
ACTTGGTCGGTTTCGTGCC -> CTTGGTCGGTTTCGTGCCA
TGCGCAGCGTGGCTTTCTC -> GCGCAGCGTGGCTTTCTCA
GCGAACGGGTTAATACCGT -> CGAACGGGTTAATACCGTA
TGACCGAACTGTTTCCCTT -> GACCGAACTGTTTCCCTTT
TGATTAGAGTGACTTTGGC -> GATTAGAGTGACTTTGGCT
CCAGCTTGCCACTCGGTTC -> CAGCTTGCCACTCGGTTCG
CACTCCAGGCTGCTGGGCA -> ACTCCAGGCTGCTGGGCAC
CCCATTTTGGGTCATCCAT -> CCATTTTGGGTCATCCATT
GTAGGACCCCCTAGTCTCA -> TAGGACCCCCTAGTCTCAC
GAAACCTCGTCGTGGTGGG -> AAACCTCGTCGTGGTGGGT
AGCGAACGAGTGGGTGCAG -> GCGAACGAGTGGGTGCAGG
ATATTCTGCTCTAGAACTA -> TATTCTGCTCTAGAACTAG
AGCCTGAATGGGAGCATCA -> GCCTGAATGGGAGCATCAG
TTGGAATGAAACCTCGTCG -> TGGAATGAAACCTCGTCGT
CGAACTGTTTCCCTTTGCG -> GAACTGTTTCCCTTTGCGA
TAGTCCTGCGTTACTGCAG -> AGTCCTGCGTTACTGCAGT
CCGTAATATCTCGGAAATC -> CGTAATATCTCGGAAATCT
TTTCAGCCTGAATGGGAGC -> TTCAGCCTGAATGGGAGCA
TCTTCGAAAGACCGTAATA -> CTTCGAAAGACCGTAATAT
AATATTGATTCTAGTGCCA -> ATATTGATTCTAGTGCCAG
ATACGCGAACGGGTTAATA -> TACGCGAACGGGTTAATAC
TGGAATGAAACCTCGTCGT -> GGAATGAAACCTCGTCGTG
CGTTCCGTTTCAGCCTGAA -> GTTCCGTTTCAGCCTGAAT
AATTTTTGGGTGGGCTTTG -> ATTTTTGGGTGGGCTTTGC
GGCACAGGCACTATACCTG -> GCACAGGCACTATACCTGA
GCGGGGAGCGTAGTCCTGC -> CGGGGAGCGTAGTCCTGCG
GATGTTGAGTCAGTGCGTG -> ATGTTGAGTCAGTGCGTGA
GCACAAGGTCAGCGTGCCA -> CACAAGGTCAGCGTGCCAC
CGCGTCTGACGCTGGTGTA -> GCGTCTGACGCTGGTGTAA
ATTACGGTAACGCGATAAT -> TTACGGTAACGCGATAATG
GTGGAGTTGGGTAGAAGCT -> TGGAGTTGGGTAGAAGCTA
GGAGCATCAGGAGGGGCGG -> GAGCATCAGGAGGGGCGGG
TGATGGTGTTATCTCGTCG -> GATGGTGTTATCTCGTCGT
TTAACACGTGGATCGAGCC -> TAACACGTGGATCGAGCCT
TAACTTTATCTGGATTTCT -> AACTTTATCTGGATTTCTC
GTAGACCAACGGCTGATCC -> TAGACCAACGGCTGATCCG
TAGCGCTTCCGTTCCGTTT -> AGCGCTTCCGTTCCGTTTC
TTATTGACGAGTCCCAGGG -> TATTGACGAGTCCCAGGGT
TATAATCCCTCCCTCACTT -> ATAATCCCTCCCTCACTTC
GCCACTCGGTTCGTCGGTC -> CCACTCGGTTCGTCGGTCA
AAACTCTCTAGCGACTGCC -> AACTCTCTAGCGACTGCCG
TTCTCAACGTACTTTATCA -> TCTCAACGTACTTTATCAT
GAATTTTTGTGTAGATCGG -> AATTTTTGTGTAGATCGGC
TCTGGATTTCTCCATGCTT -> CTGGATTTCTCCATGCTTA
CCGAGACAAATCACATTAC -> CGAGACAAATCACATTACT
TCCTGCGTTACTGCAGTAG -> CCTGCGTTACTGCAGTAGC
CACGGATGCCGCAGCGAGG -> ACGGATGCCGCAGCGAGGT
ACATTACTGAGACGTGATA -> CATTACTGAGACGTGATAC
TTGTGGTCGGCGGCACGCG -> TGTGGTCGGCGGCACGCGG
AGTCTCACTTGTTAGCTTA -> GTCTCACTTGTTAGCTTAT
TTGTACGCCTGCTATATGG -> TGTACGCCTGCTATATGGG
GATGGCTCTGTCCATCCTT -> ATGGCTCTGTCCATCCTTG
CTCCATGCTTACACGGGAA -> TCCATGCTTACACGGGAAG
CTCGATCAATTTTTGGGTG -> TCGATCAATTTTTGGGTGG
TTCTATCGCTGTTCGCCGG -> TCTATCGCTGTTCGCCGGT
TTTCCCTCGATCAATTTTT -> TTCCCTCGATCAATTTTTG
GTTTTTTATATAATCCCTC -> TTTTTTATATAATCCCTCC
TAGTAGCACAGAATAAGAC -> AGTAGCACAGAATAAGACC
CCGGGTGTCGCGAACGTGG -> CGGGTGTCGCGAACGTGGA
TTGTCTCCCACTCCAGGCT -> TGTCTCCCACTCCAGGCTG
GAGAATGCCGCTCTTGTGG -> AGAATGCCGCTCTTGTGGT
GTGGTGGGTGTAGTGCGTA -> TGGTGGGTGTAGTGCGTAG
GTCCGGTATGCCCTAGAAA -> TCCGGTATGCCCTAGAAAT
CGATGGCTCTGTCCATCCT -> GATGGCTCTGTCCATCCTT
GTATGGGATGGTAAAGTTT -> TATGGGATGGTAAAGTTTA
GAAATATTGATTCTAGTGC -> AAATATTGATTCTAGTGCC
AACTCGTGTGCGTTATTAT -> ACTCGTGTGCGTTATTATT
TGGTCGTGGCGCCCCGGGT -> GGTCGTGGCGCCCCGGGTG
ACTATCTGTGTACCAACCG -> CTATCTGTGTACCAACCGA
AGCACGAGACAGAAGTGGA -> GCACGAGACAGAAGTGGAG
TCGTTGAGCCGGACCGGAT -> CGTTGAGCCGGACCGGATC
TTTTATATAATCCCTCCCT -> TTTATATAATCCCTCCCTC
AAGACCGTAATATCTCGGA -> AGACCGTAATATCTCGGAA
GTGGTGGGTGTAGTGGCAC -> TGGTGGGTGTAGTGGCACA
AGATCGGACCTATGGCGTC -> GATCGGACCTATGGCGTCT
AGAGTGACTTTGGCTCACG -> GAGTGACTTTGGCTCACGC
TAGGATACGGGCAGATGCT -> AGGATACGGGCAGATGCTA
CCCATTCTCGTCGTGGTGG -> CCATTCTCGTCGTGGTGGG
GGCGCCCCGGGTGTCGCGA -> GCGCCCCGGGTGTCGCGAA
CTGGATTTCTCCATGCTTA -> TGGATTTCTCCATGCTTAC
TGAATGATGGTGTTATCTC -> GAATGATGGTGTTATCTCG
TTACTGAGACGTGATACCA -> TACTGAGACGTGATACCAT
ACGGGTTAATACCGTAAAC -> CGGGTTAATACCGTAAACT
AACACGGATGCCGCAGCGA -> ACACGGATGCCGCAGCGAG
GCCTAAGAATTAACGGGGA -> CCTAAGAATTAACGGGGAT
TCATCCATTGGACTTTCGA -> CATCCATTGGACTTTCGAA
TTGTACTACCGGATATCTT -> TGTACTACCGGATATCTTA
CGCGAACGGGTCACTGAAT -> GCGAACGGGTCACTGAATT
TCCGCAGTCTCAACTTGAC -> CCGCAGTCTCAACTTGACG
GTATCTGAGCCTCCACTCA -> TATCTGAGCCTCCACTCAT
GTGTGGGCTCGATGCGCAG -> TGTGGGCTCGATGCGCAGC
ACTATACCTGAATGATGGT -> CTATACCTGAATGATGGTG
TACTCAATACCAGCCTAAT -> ACTCAATACCAGCCTAATA
CATCCCATATACATAGGAG -> ATCCCATATACATAGGAGG
CCACTCATCGATAGGATAC -> CACTCATCGATAGGATACG
TCGGACCTATGGCGTCTCA -> CGGACCTATGGCGTCTCAG
CTCGTGTGCGTTATTATTG -> TCGTGTGCGTTATTATTGA
TAGCTTATCATAAGGAGTC -> AGCTTATCATAAGGAGTCC
CTAGTCCCCAGTGGATACG -> TAGTCCCCAGTGGATACGC
CGCCAACGATTGTATGGGA -> GCCAACGATTGTATGGGAT
AAAAACCCTGTGTGAAGTC -> AAAACCCTGTGTGAAGTCG
CTCATCGATAGGATACGGG -> TCATCGATAGGATACGGGC
TATTCCATAGGCTCCAGAA -> ATTCCATAGGCTCCAGAAC
GTAAACTCTCTAGCGACTG -> TAAACTCTCTAGCGACTGC
TCCCTCCCTCACTTCCGCA -> CCCTCCCTCACTTCCGCAG
TGCCCAGATCGGACCTATG -> GCCCAGATCGGACCTATGG
TAAGGTCGCCGGGCGATGG -> AAGGTCGCCGGGCGATGGC
GTAGTCCTGCGTTACTGCA -> TAGTCCTGCGTTACTGCAG
CCTATGGCGTCTCAGTCTT -> CTATGGCGTCTCAGTCTTA
TTAGAGTCACTGGTTAGCG -> TAGAGTCACTGGTTAGCGC
GATACTCAATACCAGCCTA -> ATACTCAATACCAGCCTAA
TATCATAAGGAGTCCACTC -> ATCATAAGGAGTCCACTCA
TGATTCTAGTGCCAGTGCC -> GATTCTAGTGCCAGTGCCC
AGGCACTATACCTGAATTG -> GGCACTATACCTGAATTGG
CTACCGGATATCTTACACA -> TACCGGATATCTTACACAT
GTCGTGGTGGGTGTAGTGC -> TCGTGGTGGGTGTAGTGCG
ATCTGATTAGAGTGACTTT -> TCTGATTAGAGTGACTTTG
AGGGGCGGGTCAATCAGCA -> GGGGCGGGTCAATCAGCAC
TACGTGAAGGATCACCAAC -> ACGTGAAGGATCACCAACC
CCCAGGCACTATACCTGAA -> CCAGGCACTATACCTGAAT
GGGCTTTGCCTCGTTGAGC -> GGCTTTGCCTCGTTGAGCC
CAGAATAAGACCACTCATA -> AGAATAAGACCACTCATAA
CCACTAGGCGAACGCCCAG -> CACTAGGCGAACGCCCAGG
ATCCGTATTGTACGCCTGC -> TCCGTATTGTACGCCTGCT
TACATGCGCGTGGTGTGGG -> ACATGCGCGTGGTGTGGGC
GATGCCGCAGCGAGGTCAT -> ATGCCGCAGCGAGGTCATG
GATGACTTGTACTACCGGA -> ATGACTTGTACTACCGGAT
GTCACTGGTTAGCGCTTCC -> TCACTGGTTAGCGCTTCCG
CGCAGTCTCAACTTGACGA -> GCAGTCTCAACTTGACGAG
TAGTGCGGCTCTCGTCGTG -> AGTGCGGCTCTCGTCGTGG
GTGGGGCGGTATCTAAGCG -> TGGGGCGGTATCTAAGCGA
GCCCATTCTCGTCGTGGTG -> CCCATTCTCGTCGTGGTGG
CAGAAGTGGAGTTGGGTAG -> AGAAGTGGAGTTGGGTAGA
TAATCCCTCCCTCACTTCC -> AATCCCTCCCTCACTTCCG
GACTGCCGACAATACGAAT -> ACTGCCGACAATACGAATT
GGACCTATGGCGTCTCAGT -> GACCTATGGCGTCTCAGTC
CACTCATAATATGCGGTTT -> ACTCATAATATGCGGTTTT
GGATGACTATCTGTGTACC -> GATGACTATCTGTGTACCA
CAGGCACTATACCTGAATT -> AGGCACTATACCTGAATTG
ACACGTGGATCGAGCCTCA -> CACGTGGATCGAGCCTCAG
TTCAGCCTGAATGGGAGCA -> TCAGCCTGAATGGGAGCAT
ATGGGAGCATCAGGAGGGG -> TGGGAGCATCAGGAGGGGC
ACAACACGGATGCCGCAGC -> CAACACGGATGCCGCAGCG
CTACTGTCTTCGAAAGACC -> TACTGTCTTCGAAAGACCG
TCAATCAGCACGTCTCGCG -> CAATCAGCACGTCTCGCGT
GACAATTTGTGACCAACAC -> ACAATTTGTGACCAACACA
TGCCACTCGGTTCGTCGGT -> GCCACTCGGTTCGTCGGTC
GCGTCTCAGTCTTAAAGCC -> CGTCTCAGTCTTAAAGCCT
CAGGCACTATACCTGAATG -> AGGCACTATACCTGAATGA
GTACATGCGCGTGGTGTGG -> TACATGCGCGTGGTGTGGG
CAGGCACTATACCTGAATC -> AGGCACTATACCTGAATCT
TCTTGCACAAGGTCAGCGT -> CTTGCACAAGGTCAGCGTG
TGCCCTAGAAATATTGATT -> GCCCTAGAAATATTGATTC
GCGGCACGCGGGGAGCGTA -> CGGCACGCGGGGAGCGTAG
CAGGCACTATACCTGAATA -> AGGCACTATACCTGAATAA
GGCACTATACCTGAATTGG -> GCACTATACCTGAATTGGA
GTCATGCGATCCCGGACTG -> TCATGCGATCCCGGACTGG
CCAGTGGATACGCGAACGG -> CAGTGGATACGCGAACGGG
CCTAATGGGTCGCCAACGA -> CTAATGGGTCGCCAACGAT
CTGCTATATGGGTAGGACC -> TGCTATATGGGTAGGACCC
GAAAGACCGTAATATCTCG -> AAAGACCGTAATATCTCGG
TGTCCATCCTTGGCTACGA -> GTCCATCCTTGGCTACGAA
TGGCTCACGCGAACGGGTC -> GGCTCACGCGAACGGGTCA
GCCCTAGAAATATTGATTC -> CCCTAGAAATATTGATTCT
GCCGGTCTTGCACAAGGTC -> CCGGTCTTGCACAAGGTCA
CTCGATGCGCAGCGTGGCT -> TCGATGCGCAGCGTGGCTT
CCGACAATACGAATTACTT -> CGACAATACGAATTACTTG
TGCGGATGAGCAAGAAAAT -> GCGGATGAGCAAGAAAATG
CATACGCAGTGGGGCGGTA -> ATACGCAGTGGGGCGGTAT
CGATCCCGGACTGGTCGTG -> GATCCCGGACTGGTCGTGG
GGGCTCGATGCGCAGCGTG -> GGCTCGATGCGCAGCGTGG
GTCGTGGTGGGTGTAGCGC -> TCGTGGTGGGTGTAGCGCT
AAATCACATTACTGAGACG -> AATCACATTACTGAGACGT
TAGCACGTACATGCGCGTG -> AGCACGTACATGCGCGTGG
GTCGTTTCCCTCGATCAAT -> TCGTTTCCCTCGATCAATT
CGGGAAGCGCGTTAGTAGC -> GGGAAGCGCGTTAGTAGCA
TTGGGTAGAAGCTATTCCA -> TGGGTAGAAGCTATTCCAT
GCTGGGCACTCGTAGCCCT -> CTGGGCACTCGTAGCCCTG
CTGCTGTTCCGGGGATGTT -> TGCTGTTCCGGGGATGTTG
TAGGAGGGAACCGGCTATT -> AGGAGGGAACCGGCTATTC
CTGTTTCCCTTTGCGACAA -> TGTTTCCCTTTGCGACAAT
CCTCGATCAATTTTTGGGT -> CTCGATCAATTTTTGGGTG
CTTTGGCTCACGCGAACGG -> TTTGGCTCACGCGAACGGG
TACGTCGTTTCCCTCGATC -> ACGTCGTTTCCCTCGATCA
TGCCAAACCCATAGAAGTG -> GCCAAACCCATAGAAGTGG
GTGACTTTGGCTCACGCGA -> TGACTTTGGCTCACGCGAA
AACTAGTCCCCAGTGGATA -> ACTAGTCCCCAGTGGATAC
TCACCAACCAGCTTGCCAC -> CACCAACCAGCTTGCCACT
AGTATCTGAGCCTCCACTC -> GTATCTGAGCCTCCACTCA
TGGGTAGGACCCCCTAGTC -> GGGTAGGACCCCCTAGTCT
TCATCGATAGGATACGGGC -> CATCGATAGGATACGGGCA
GAAGTGGAGTTGGGTAGAA -> AAGTGGAGTTGGGTAGAAG
ACGGGAAGCGCGTTAGTAG -> CGGGAAGCGCGTTAGTAGC
AACGGCTGATCCGTTGTCT -> ACGGCTGATCCGTTGTCTC
TTCTCGTCGTGGTGGGTGT -> TCTCGTCGTGGTGGGTGTA
TCTTACACATCAGGCACTA -> CTTACACATCAGGCACTAT
TCGGAAATCTCCCTCATCT -> CGGAAATCTCCCTCATCTA
TACCTGAATGATGGTGTTA -> ACCTGAATGATGGTGTTAT
GAGGGAACCGGCTATTCGA -> AGGGAACCGGCTATTCGAG
ACTGGTCGTGGCGCCCCGG -> CTGGTCGTGGCGCCCCGGG
AGCATTCACTTTACCAGAA -> GCATTCACTTTACCAGAAC
AAGCGCGTTAGTAGCACAG -> AGCGCGTTAGTAGCACAGA
GCAGACGTCCGGTATGCCC -> CAGACGTCCGGTATGCCCT
TCGGTCATATCGTCACACC -> CGGTCATATCGTCACACCG
CATATACATAGGAGGGAAC -> ATATACATAGGAGGGAACC
CGCTTCCGTTCCGTTTCAG -> GCTTCCGTTCCGTTTCAGC
ATCCAAAAAATACCCGGCT -> TCCAAAAAATACCCGGCTA
ACTGGTTAGCGCTTCCGTT -> CTGGTTAGCGCTTCCGTTC
GTCGTGGTGGGTGTAGTGG -> TCGTGGTGGGTGTAGTGGC
TCAGCGTGCCACTAGGCGA -> CAGCGTGCCACTAGGCGAA
CATACCGAGACAAATCACA -> ATACCGAGACAAATCACAT
CTATTCGAGTAGGTAGTGA -> TATTCGAGTAGGTAGTGAT
AATCCCTCCCTCACTTCCG -> ATCCCTCCCTCACTTCCGC
CCGGCTATTCGAGTAGGTA -> CGGCTATTCGAGTAGGTAG
GGAATGAAACCTCGTCGTG -> GAATGAAACCTCGTCGTGG
GTGACCAACACACTAGTAG -> TGACCAACACACTAGTAGG
GTCGGCGGCACGCGGGGAG -> TCGGCGGCACGCGGGGAGC
TTGCCACTCGGTTCGTCGG -> TGCCACTCGGTTCGTCGGT
GGCACGCGGGGAGCGTAGT -> GCACGCGGGGAGCGTAGTC
AGGCGAACGCCCAGGCACT -> GGCGAACGCCCAGGCACTA
TAGACGACACACAACACGG -> AGACGACACACAACACGGA
AAGTGGATTGCGGATGAGC -> AGTGGATTGCGGATGAGCA
TCGCTGTTCGCCGGTCTTG -> CGCTGTTCGCCGGTCTTGC
CCGGTCTTGCACAAGGTCA -> CGGTCTTGCACAAGGTCAG
TGCTGTTCCGGGGATGTTG -> GCTGTTCCGGGGATGTTGA
ATTTATTACGGTAACGCGA -> TTTATTACGGTAACGCGAT
AAGCCTAATGGGTCGCCAA -> AGCCTAATGGGTCGCCAAC
ACGCGCTGCGATGCCTAAG -> CGCGCTGCGATGCCTAAGA
GAATGCCGCTCTTGTGGTC -> AATGCCGCTCTTGTGGTCG
CCATTCTCGTCGTGGTGGG -> CATTCTCGTCGTGGTGGGT
TGGGTAGAAGCTATTCCAT -> GGGTAGAAGCTATTCCATA
GCGTTTTTTATATAATCCC -> CGTTTTTTATATAATCCCT
ACACTAGTAGGCACAGGCA -> CACTAGTAGGCACAGGCAC
TGGTTAGCGCTTCCGTTCC -> GGTTAGCGCTTCCGTTCCG
AGGTCGCCGGGCGATGGCT -> GGTCGCCGGGCGATGGCTC
TGCTAGCACGTACATGCGC -> GCTAGCACGTACATGCGCG
CTTTATCTGGATTTCTCCA -> TTTATCTGGATTTCTCCAT
AAATCCGTATTGTACGCCT -> AATCCGTATTGTACGCCTG
CATTACTGAGACGTGATAC -> ATTACTGAGACGTGATACC
CATGCGATCCCGGACTGGT -> ATGCGATCCCGGACTGGTC
AGACGACACACAACACGGA -> GACGACACACAACACGGAT
TCTCAACGTACTTTATCAT -> CTCAACGTACTTTATCATA
CATAGGCTCCAGAACACGC -> ATAGGCTCCAGAACACGCG
CGGATGAGCAAGAAAATGC -> GGATGAGCAAGAAAATGCA
AGTTTAATGTTCCATACGC -> GTTTAATGTTCCATACGCA
TTCTCCATGCTTACACGGG -> TCTCCATGCTTACACGGGA
CGGTCTTGCACAAGGTCAG -> GGTCTTGCACAAGGTCAGC
TCTGTCCATCCTTGGCTAC -> CTGTCCATCCTTGGCTACG
TTTTAGACGACACACAACA -> TTTAGACGACACACAACAC
TCGTCGGTCATATCGTCAC -> CGTCGGTCATATCGTCACA
GTAACGCGATAATGCCATT -> TAACGCGATAATGCCATTT
ACCATACGTCGTTTCCCTC -> CCATACGTCGTTTCCCTCG
CTTTCGAATTGTATGCCCC -> TTTCGAATTGTATGCCCCC
GTGGGTGTAGCGCTGCCAT -> TGGGTGTAGCGCTGCCATC
TGCTGGGCACTCGTAGCCC -> GCTGGGCACTCGTAGCCCT
CACTATACCTGAATTGGAA -> ACTATACCTGAATTGGAAT
AAATCTCCCTCATCTAACT -> AATCTCCCTCATCTAACTT
GTCATCCATTGGACTTTCG -> TCATCCATTGGACTTTCGA
CGTGTGCGTTATTATTGAC -> GTGTGCGTTATTATTGACG
AGGGAACCGGCTATTCGAG -> GGGAACCGGCTATTCGAGT
GAAATCTCCCTCATCTAAC -> AAATCTCCCTCATCTAACT
CTCAGGATGCGTGCAGTCT -> TCAGGATGCGTGCAGTCTA
CTGGTGTAAATCCGTATTG -> TGGTGTAAATCCGTATTGT
ATACCTGAATGATGGTGTT -> TACCTGAATGATGGTGTTA
CTGCGCATTTATTACGGTA -> TGCGCATTTATTACGGTAA
GGGTGTAGCGCTGCCATCC -> GGTGTAGCGCTGCCATCCC
AACGCACGTCGCACATTCA -> ACGCACGTCGCACATTCAA
CTCCAGGCTGCTGGGCACT -> TCCAGGCTGCTGGGCACTC
AAAATGAACTCGTGTGCGT -> AAATGAACTCGTGTGCGTT
ACGGCTGATCCGTTGTCTC -> CGGCTGATCCGTTGTCTCC
ATGCAGCTTTGCCCCATTT -> TGCAGCTTTGCCCCATTTT
TAAGAATTAACGGGGATCT -> AAGAATTAACGGGGATCTG
AAAGCACATCCACGGAGAT -> AAGCACATCCACGGAGATC
GGACCCCCTAGTCTCACTT -> GACCCCCTAGTCTCACTTG
GCGCAGCGTGGCTTTCTCA -> CGCAGCGTGGCTTTCTCAA
ACCGTAAACTCTCTAGCGA -> CCGTAAACTCTCTAGCGAC
TGTCTCCCACTCCAGGCTG -> GTCTCCCACTCCAGGCTGC
CTCGGAAATCTCCCTCATC -> TCGGAAATCTCCCTCATCT
GCCTAATACGTTGGACCCT -> CCTAATACGTTGGACCCTA
GCACATTCAATTATATTCT -> CACATTCAATTATATTCTG
CGAGTGGGTGCAGGCACTA -> GAGTGGGTGCAGGCACTAT
ATGCTAGCACGTACATGCG -> TGCTAGCACGTACATGCGC
GCGGCTCTCGTCGTGGTGG -> CGGCTCTCGTCGTGGTGGG
CGTGATACCATTCGCCGCA -> GTGATACCATTCGCCGCAC
TCCAGTATCTGAGCCTCCA -> CCAGTATCTGAGCCTCCAC
GCCCAGATCGGACCTATGG -> CCCAGATCGGACCTATGGC
AAACGGTAGCACGAGACAG -> AACGGTAGCACGAGACAGA
GGCGAACGCCCAGGCACTA -> GCGAACGCCCAGGCACTAT
CCAGTATCTGAGCCTCCAC -> CAGTATCTGAGCCTCCACT
AAACCTCGTCGTGGTGGGT -> AACCTCGTCGTGGTGGGTG
TCGTGGTGGGTGTAGCGCT -> CGTGGTGGGTGTAGCGCTG
CATTCTCGTCGTGGTGGGT -> ATTCTCGTCGTGGTGGGTG
CGCGGGGAGCGTAGTCCTG -> GCGGGGAGCGTAGTCCTGC
ATACCATTCGCCGCACTGA -> TACCATTCGCCGCACTGAT
TCGTGCCAAACCCATAGAA -> CGTGCCAAACCCATAGAAG
GTTTTCTCGTAGGAGGAAT -> TTTTCTCGTAGGAGGAATT
CGATCAATTTTTGGGTGGG -> GATCAATTTTTGGGTGGGC
TCGTGTGCGTTATTATTGA -> CGTGTGCGTTATTATTGAC
GTGGTGGGTGTAGCGCTGC -> TGGTGGGTGTAGCGCTGCC
AACGCCCAGGCACTATACC -> ACGCCCAGGCACTATACCT
GGGTGTAGACTGCGCATTT -> GGTGTAGACTGCGCATTTA
TGCCGCAGCGAGGTCATGC -> GCCGCAGCGAGGTCATGCG
GCATTCACTTTACCAGAAC -> CATTCACTTTACCAGAACG
GACCGTAATATCTCGGAAA -> ACCGTAATATCTCGGAAAT
GCCTCGTTGAGCCGGACCG -> CCTCGTTGAGCCGGACCGG
GATAATGCCATTTTAGAGT -> ATAATGCCATTTTAGAGTC
GTCAGCGTGCCACTAGGCG -> TCAGCGTGCCACTAGGCGA
TGCATTGGTTATAGAAACG -> GCATTGGTTATAGAAACGG
GTTTTTAGACGACACACAA -> TTTTTAGACGACACACAAC
CTCCCTCATCTAACTTTAT -> TCCCTCATCTAACTTTATC
AATCTCCCTCATCTAACTT -> ATCTCCCTCATCTAACTTT
CCCTTTGCGACAATTTGTG -> CCTTTGCGACAATTTGTGA
AATGAACTCGTGTGCGTTA -> ATGAACTCGTGTGCGTTAT
GGCTCTGTCCATCCTTGGC -> GCTCTGTCCATCCTTGGCT
ACCATTCGCCGCACTGATA -> CCATTCGCCGCACTGATAC
CAATTATATTCTGCTCTAG -> AATTATATTCTGCTCTAGA
CTGGTCGTGGCGCCCCGGG -> TGGTCGTGGCGCCCCGGGT
AGTCAGTGCGTGATTGGCA -> GTCAGTGCGTGATTGGCAG
AGGCACTATACCTGAATGA -> GGCACTATACCTGAATGAT
ACTGTTTCCCTTTGCGACA -> CTGTTTCCCTTTGCGACAA
GTAGCATTCACTTTACCAG -> TAGCATTCACTTTACCAGA
TCTCACTTGTTAGCTTATC -> CTCACTTGTTAGCTTATCA
TTTCGTGCCAAACCCATAG -> TTCGTGCCAAACCCATAGA
CGATTGTATGGGATGGTAA -> GATTGTATGGGATGGTAAA
GGGCGGGTCAATCAGCACG -> GGCGGGTCAATCAGCACGT
TGCTCTAGAACTAGTCCCC -> GCTCTAGAACTAGTCCCCA
ATAATATGCGGTTTTCTCG -> TAATATGCGGTTTTCTCGT
GTCGGTTTCGTGCCAAACC -> TCGGTTTCGTGCCAAACCC
TGGGCACTCGTAGCCCTGG -> GGGCACTCGTAGCCCTGGA
TGGAACCGATACTCAATAC -> GGAACCGATACTCAATACC
GCCTGAATGGGAGCATCAG -> CCTGAATGGGAGCATCAGG
TTAATACCGTAAACTCTCT -> TAATACCGTAAACTCTCTA
CGTGGCGCCCCGGGTGTCG -> GTGGCGCCCCGGGTGTCGC
TAGGCTCCAGAACACGCGC -> AGGCTCCAGAACACGCGCT
CATCCTTGGCTACGAAGCA -> ATCCTTGGCTACGAAGCAG
TGCGTGCAGTCTACTGTCT -> GCGTGCAGTCTACTGTCTT
CTAAGAATTAACGGGGATC -> TAAGAATTAACGGGGATCT
AAGTGGAGTTGGGTAGAAG -> AGTGGAGTTGGGTAGAAGC
CGCGTGGTGTGGGCTCGAT -> GCGTGGTGTGGGCTCGATG
ACGCACGTCGCACATTCAA -> CGCACGTCGCACATTCAAT
GCGGGTCAATCAGCACGTC -> CGGGTCAATCAGCACGTCT
GCGGATGAGCAAGAAAATG -> CGGATGAGCAAGAAAATGC
CGAACGTGGAGAATCCAGT -> GAACGTGGAGAATCCAGTA
TGCCACTAGGCGAACGCCC -> GCCACTAGGCGAACGCCCA
ACGGCCCATTCTCGTCGTG -> CGGCCCATTCTCGTCGTGG
CAGTAGCATTCACTTTACC -> AGTAGCATTCACTTTACCA
GACCCTATCGAGAATGCCG -> ACCCTATCGAGAATGCCGC
AGAGTCACTGGTTAGCGCT -> GAGTCACTGGTTAGCGCTT
CCAACCAGCTTGCCACTCG -> CAACCAGCTTGCCACTCGG
TGGGTGTAGACTGCGCATT -> GGGTGTAGACTGCGCATTT
CGTGGATCGAGCCTCAGGA -> GTGGATCGAGCCTCAGGAT
GGGGATGTTGAGTCAGTGC -> GGGATGTTGAGTCAGTGCG
AGACTGCGCATTTATTACG -> GACTGCGCATTTATTACGG
CTGAATGGGAGCATCAGGA -> TGAATGGGAGCATCAGGAG
CCTCGTTGAGCCGGACCGG -> CTCGTTGAGCCGGACCGGA
TCTCCATGCTTACACGGGA -> CTCCATGCTTACACGGGAA
CTTTGCCTCGTTGAGCCGG -> TTTGCCTCGTTGAGCCGGA
TAAATCCGTATTGTACGCC -> AAATCCGTATTGTACGCCT
GACTGCGCATTTATTACGG -> ACTGCGCATTTATTACGGT
TACCTGAATCTAGTGCGGC -> ACCTGAATCTAGTGCGGCT
CTTTTCTATCGCTGTTCGC -> TTTTCTATCGCTGTTCGCC
ACCGTAATATCTCGGAAAT -> CCGTAATATCTCGGAAATC
GTTGAGTCAGTGCGTGATT -> TTGAGTCAGTGCGTGATTG
GGCACTATACCTGAATGAT -> GCACTATACCTGAATGATG
CCATCCCATATACATAGGA -> CATCCCATATACATAGGAG
TATATGGGTAGGACCCCCT -> ATATGGGTAGGACCCCCTA
ACCCTGTGTGAAGTCGGTA -> CCCTGTGTGAAGTCGGTAA
AATACCAGCCTAATACGTT -> ATACCAGCCTAATACGTTG
ATGGTAAAGTTTAATGTTC -> TGGTAAAGTTTAATGTTCC
ACAAGGTCAGCGTGCCACT -> CAAGGTCAGCGTGCCACTA
TAGTGATGACTTGTACTAC -> AGTGATGACTTGTACTACC
GTCTCAGTCTTAAAGCCTA -> TCTCAGTCTTAAAGCCTAA
CTACGAAGCAGCGCGTCTG -> TACGAAGCAGCGCGTCTGA
CATGTTGCATTGGTTATAG -> ATGTTGCATTGGTTATAGA
GAACGGGTTAATACCGTAA -> AACGGGTTAATACCGTAAA
GTTTCCCTCGATCAATTTT -> TTTCCCTCGATCAATTTTT
CATCCATTGGACTTTCGAA -> ATCCATTGGACTTTCGAAT
TCAGCACGTCTCGCGTTTT -> CAGCACGTCTCGCGTTTTT
CATTGGTTATAGAAACGGT -> ATTGGTTATAGAAACGGTA
TCGAATTGTATGCCCCCGC -> CGAATTGTATGCCCCCGCA
CCGGATCACGCGTAGACCA -> CGGATCACGCGTAGACCAA
ATTCTCGTCGTGGTGGGTG -> TTCTCGTCGTGGTGGGTGT
ACTGATACGTGAAGGATCA -> CTGATACGTGAAGGATCAC
GGAATTGACCGAACTGTTT -> GAATTGACCGAACTGTTTC
CGGATCACGCGTAGACCAA -> GGATCACGCGTAGACCAAC
CCACTCCAGGCTGCTGGGC -> CACTCCAGGCTGCTGGGCA
TCCACGCGTCGCCATGTTG -> CCACGCGTCGCCATGTTGC
TGTCGCGAACGTGGAGAAT -> GTCGCGAACGTGGAGAATC
TACTGCAGTAGCATTCACT -> ACTGCAGTAGCATTCACTT
TGTAGTGCGTAGTTTTTAG -> GTAGTGCGTAGTTTTTAGA
TTGTGTAGATCGGCGGTAA -> TGTGTAGATCGGCGGTAAA
GGGCGATGGCTCTGTCCAT -> GGCGATGGCTCTGTCCATC
AACTCTCTAGCGACTGCCG -> ACTCTCTAGCGACTGCCGA
TCCCACTCCAGGCTGCTGG -> CCCACTCCAGGCTGCTGGG
TTTGCGACAATTTGTGACC -> TTGCGACAATTTGTGACCA
AAAATGCATTAAGGTCGCC -> AAATGCATTAAGGTCGCCG
ATTTTGGGTCATCCATTGG -> TTTTGGGTCATCCATTGGA
GCTACGAAGCAGCGCGTCT -> CTACGAAGCAGCGCGTCTG
GCTCTTGTGGTCGGCGGCA -> CTCTTGTGGTCGGCGGCAC
GCGCTTCCGTTCCGTTTCA -> CGCTTCCGTTCCGTTTCAG
CATTTTAGAGTCACTGGTT -> ATTTTAGAGTCACTGGTTA
CCTCATCTAACTTTATCTG -> CTCATCTAACTTTATCTGG
TGATCCGTTGTCTCCCACT -> GATCCGTTGTCTCCCACTC
GCACTCGTAGCCCTGGAAC -> CACTCGTAGCCCTGGAACC
GTTCCATACGCAGTGGGGC -> TTCCATACGCAGTGGGGCG
TCGGTTTCGTGCCAAACCC -> CGGTTTCGTGCCAAACCCA
GTGGTCGGCGGCACGCGGG -> TGGTCGGCGGCACGCGGGG
ATTGATTCTAGTGCCAGTG -> TTGATTCTAGTGCCAGTGC
ACCGCCCTGCTGTTCCGGG -> CCGCCCTGCTGTTCCGGGG
TGTGACCAACACACTAGTA -> GTGACCAACACACTAGTAG
GCACGTCGCACATTCAATT -> CACGTCGCACATTCAATTA
GGCTGATCCGTTGTCTCCC -> GCTGATCCGTTGTCTCCCA
CTAGTAGGCACAGGCACTA -> TAGTAGGCACAGGCACTAT
ACCAGCCTAATACGTTGGA -> CCAGCCTAATACGTTGGAC
TACCAGCCTAATACGTTGG -> ACCAGCCTAATACGTTGGA
AGGAATTGACCGAACTGTT -> GGAATTGACCGAACTGTTT
CGGGTGTCGCGAACGTGGA -> GGGTGTCGCGAACGTGGAG
AGAAACGGTAGCACGAGAC -> GAAACGGTAGCACGAGACA
TGAAACCTCGTCGTGGTGG -> GAAACCTCGTCGTGGTGGG
CCGTTTCAGCCTGAATGGG -> CGTTTCAGCCTGAATGGGA
GGGTGGGCTTTGCCTCGTT -> GGTGGGCTTTGCCTCGTTG
CTTCCGCAGTCTCAACTTG -> TTCCGCAGTCTCAACTTGA
GAATGAAACCTCGTCGTGG -> AATGAAACCTCGTCGTGGT
AACGGGTCACTGAATTTTT -> ACGGGTCACTGAATTTTTG
ATGGCTCTGTCCATCCTTG -> TGGCTCTGTCCATCCTTGG
AATGATGGTGTTATCTCGT -> ATGATGGTGTTATCTCGTC
TACGTTGGACCCTATCGAG -> ACGTTGGACCCTATCGAGA
GCACGAGACAGAAGTGGAG -> CACGAGACAGAAGTGGAGT
CAGTATCTGAGCCTCCACT -> AGTATCTGAGCCTCCACTC
GGGTTAATACCGTAAACTC -> GGTTAATACCGTAAACTCT
CGGGGATCTGATTAGAGTG -> GGGGATCTGATTAGAGTGA
CTTAAAGCCTAATGGGTCG -> TTAAAGCCTAATGGGTCGC
GGCTTTCTCAACGTACTTT -> GCTTTCTCAACGTACTTTA
AGCGAGGTCATGCGATCCC -> GCGAGGTCATGCGATCCCG
CCTCAGGATGCGTGCAGTC -> CTCAGGATGCGTGCAGTCT
ATGGGTCGCCAACGATTGT -> TGGGTCGCCAACGATTGTA
CATTCGCCGCACTGATACG -> ATTCGCCGCACTGATACGT
CCTAGAAATATTGATTCTA -> CTAGAAATATTGATTCTAG
GTTTCCCTTTGCGACAATT -> TTTCCCTTTGCGACAATTT
CCCTAGAAATATTGATTCT -> CCTAGAAATATTGATTCTA
CGTGAAGGATCACCAACCA -> GTGAAGGATCACCAACCAG
GCCGCACTGATACGTGAAG -> CCGCACTGATACGTGAAGG
CGAACGGGTCACTGAATTT -> GAACGGGTCACTGAATTTT
ATCCATTGGACTTTCGAAT -> TCCATTGGACTTTCGAATT
TACGCCTGCTATATGGGTA -> ACGCCTGCTATATGGGTAG
TAACGGCCCATTCTCGTCG -> AACGGCCCATTCTCGTCGT
TAGTGGCACACGTGGATGA -> AGTGGCACACGTGGATGAC
ACAGAAGTGGAGTTGGGTA -> CAGAAGTGGAGTTGGGTAG
CTAATACGTTGGACCCTAT -> TAATACGTTGGACCCTATC
ACACACTAGTAGGCACAGG -> CACACTAGTAGGCACAGGC
GGTAGAAGCTATTCCATAG -> GTAGAAGCTATTCCATAGG
GGCACTCGTAGCCCTGGAA -> GCACTCGTAGCCCTGGAAC
TTATAGAAACGGTAGCACG -> TATAGAAACGGTAGCACGA
GTTAATACCGTAAACTCTC -> TTAATACCGTAAACTCTCT
GATGAGCAAGAAAATGCAT -> ATGAGCAAGAAAATGCATT
GACGACACACAACACGGAT -> ACGACACACAACACGGATG
GCGTTAGTAGCACAGAATA -> CGTTAGTAGCACAGAATAA
CAACCGAAAGCACATCCAC -> AACCGAAAGCACATCCACG
TCTAGCGACTGCCGACAAT -> CTAGCGACTGCCGACAATA
ATCCTTGGCTACGAAGCAG -> TCCTTGGCTACGAAGCAGC
GGCTAGTTCCTTTTCTATC -> GCTAGTTCCTTTTCTATCG
GCGATGGCTCTGTCCATCC -> CGATGGCTCTGTCCATCCT
GCAACCATACGTCGTTTCC -> CAACCATACGTCGTTTCCC
GCAGTGGGGCGGTATCTAA -> CAGTGGGGCGGTATCTAAG
AAACCCTGTGTGAAGTCGG -> AACCCTGTGTGAAGTCGGT
CGGCTATTCGAGTAGGTAG -> GGCTATTCGAGTAGGTAGT
ATACGCAGTGGGGCGGTAT -> TACGCAGTGGGGCGGTATC
GCATTGGTTATAGAAACGG -> CATTGGTTATAGAAACGGT
CCAGGCTGCTGGGCACTCG -> CAGGCTGCTGGGCACTCGT
GGGGCGGTATCTAAGCGAA -> GGGCGGTATCTAAGCGAAC
AATCTAGTGCGGCTCTCGT -> ATCTAGTGCGGCTCTCGTC
GTAGGTAGTGATGACTTGT -> TAGGTAGTGATGACTTGTA
GCAGCGTGGCTTTCTCAAC -> CAGCGTGGCTTTCTCAACG
AAATGCATTAAGGTCGCCG -> AATGCATTAAGGTCGCCGG
TCGTCACACCGCCCTGCTG -> CGTCACACCGCCCTGCTGT
GTACTTTATCATAAGCATA -> TACTTTATCATAAGCATAA
GATGGTGTTATCTCGTCGT -> ATGGTGTTATCTCGTCGTG
GGATCACGCGTAGACCAAC -> GATCACGCGTAGACCAACG
GTCTCGCGTTTTTTATATA -> TCTCGCGTTTTTTATATAA
GTGCAGTCTACTGTCTTCG -> TGCAGTCTACTGTCTTCGA
TAGAAACGGTAGCACGAGA -> AGAAACGGTAGCACGAGAC
GTCTTGCACAAGGTCAGCG -> TCTTGCACAAGGTCAGCGT
TTACACGGGAAGCGCGTTA -> TACACGGGAAGCGCGTTAG
TCGCACATTCAATTATATT -> CGCACATTCAATTATATTC
TCGGTTCGTCGGTCATATC -> CGGTTCGTCGGTCATATCG
TCCATACGCAGTGGGGCGG -> CCATACGCAGTGGGGCGGT
ATCACATTACTGAGACGTG -> TCACATTACTGAGACGTGA
CTCAACTTGACGAGCTTAA -> TCAACTTGACGAGCTTAAC
TGCCCCCGCAACCATACGT -> GCCCCCGCAACCATACGTC
GCCTCAGGATGCGTGCAGT -> CCTCAGGATGCGTGCAGTC
GTTATCTCGTCGTGGTGGG -> TTATCTCGTCGTGGTGGGT
GGCTCGATGCGCAGCGTGG -> GCTCGATGCGCAGCGTGGC
GTCCATCCTTGGCTACGAA -> TCCATCCTTGGCTACGAAG
CCAAACCCATAGAAGTGGA -> CAAACCCATAGAAGTGGAT
GACTATCTGTGTACCAACC -> ACTATCTGTGTACCAACCG
GCGATAATGCCATTTTAGA -> CGATAATGCCATTTTAGAG
TCATGCGATCCCGGACTGG -> CATGCGATCCCGGACTGGT
CAACACACTAGTAGGCACA -> AACACACTAGTAGGCACAG
ACCGGATCACGCGTAGACC -> CCGGATCACGCGTAGACCA
TGAATTTTTGTGTAGATCG -> GAATTTTTGTGTAGATCGG
GTACCAACCGAAAGCACAT -> TACCAACCGAAAGCACATC
CCGCAGCGAGGTCATGCGA -> CGCAGCGAGGTCATGCGAT
TCCAGAACACGCGCTGCGA -> CCAGAACACGCGCTGCGAT
GGCAGACGTCCGGTATGCC -> GCAGACGTCCGGTATGCCC
CTTGCACAAGGTCAGCGTG -> TTGCACAAGGTCAGCGTGC
TTTGTGACCAACACACTAG -> TTGTGACCAACACACTAGT
TCTGCTCTAGAACTAGTCC -> CTGCTCTAGAACTAGTCCC
GTTTAATGTTCCATACGCA -> TTTAATGTTCCATACGCAG
CAAGAAAATGCATTAAGGT -> AAGAAAATGCATTAAGGTC
TATGGGTAGGACCCCCTAG -> ATGGGTAGGACCCCCTAGT
GCCGACAATACGAATTACT -> CCGACAATACGAATTACTT
TCCATCCTTGGCTACGAAG -> CCATCCTTGGCTACGAAGC
TGGTGGGTGTAGTGCGTAG -> GGTGGGTGTAGTGCGTAGT
CAACGATTGTATGGGATGG -> AACGATTGTATGGGATGGT
CGACACACAACACGGATGC -> GACACACAACACGGATGCC
GCTTATCATAAGGAGTCCA -> CTTATCATAAGGAGTCCAC
CTGCCGACAATACGAATTA -> TGCCGACAATACGAATTAC
TTAAGGTCGCCGGGCGATG -> TAAGGTCGCCGGGCGATGG
CTAGAACTAGTCCCCAGTG -> TAGAACTAGTCCCCAGTGG
TTGACGAGCTTAACACGTG -> TGACGAGCTTAACACGTGG
TACTGTCTTCGAAAGACCG -> ACTGTCTTCGAAAGACCGT
ACGTGGAGAATCCAGTATC -> CGTGGAGAATCCAGTATCT
CCCTAGTCTCACTTGTTAG -> CCTAGTCTCACTTGTTAGC
GTGCGTGATTGGCAGACGT -> TGCGTGATTGGCAGACGTC
CGCTGTTCGCCGGTCTTGC -> GCTGTTCGCCGGTCTTGCA
TGTTGAGTCAGTGCGTGAT -> GTTGAGTCAGTGCGTGATT
GCATTTATTACGGTAACGC -> CATTTATTACGGTAACGCG
ACTTTACCAGAACGCACGT -> CTTTACCAGAACGCACGTC
TTAGCTTATCATAAGGAGT -> TAGCTTATCATAAGGAGTC
TATCTTACACATCAGGCAC -> ATCTTACACATCAGGCACT
TTTAATGTTCCATACGCAG -> TTAATGTTCCATACGCAGT
GTCCACTCATACCGAGACA -> TCCACTCATACCGAGACAA
ACTGAATTTTTGTGTAGAT -> CTGAATTTTTGTGTAGATC
CCAGAACGCACGTCGCACA -> CAGAACGCACGTCGCACAT
CGTAGTCCTGCGTTACTGC -> GTAGTCCTGCGTTACTGCA
CACTTTACCAGAACGCACG -> ACTTTACCAGAACGCACGT
CACAGGCACTATACCTGAA -> ACAGGCACTATACCTGAAT
ATGAGCAAGAAAATGCATT -> TGAGCAAGAAAATGCATTA
CCCCTAGTCTCACTTGTTA -> CCCTAGTCTCACTTGTTAG
CACTCATCGATAGGATACG -> ACTCATCGATAGGATACGG
ATACCTGAATAACGGCCCA -> TACCTGAATAACGGCCCAT
CGCACTGATACGTGAAGGA -> GCACTGATACGTGAAGGAT
CGGCTGATCCGTTGTCTCC -> GGCTGATCCGTTGTCTCCC
CGATACTCAATACCAGCCT -> GATACTCAATACCAGCCTA
TCGCCAACGATTGTATGGG -> CGCCAACGATTGTATGGGA
ACATGCGCGTGGTGTGGGC -> CATGCGCGTGGTGTGGGCT
AGCATAAAAACCCTGTGTG -> GCATAAAAACCCTGTGTGA
TGCGACAATTTGTGACCAA -> GCGACAATTTGTGACCAAC
ATCGTTGGACTCTTATGCA -> TCGTTGGACTCTTATGCAG
TGTTATCTCGTCGTGGTGG -> GTTATCTCGTCGTGGTGGG
TTCTGCTCTAGAACTAGTC -> TCTGCTCTAGAACTAGTCC
CCTGAATGGGAGCATCAGG -> CTGAATGGGAGCATCAGGA
CCATAGAAGTGGATTGCGG -> CATAGAAGTGGATTGCGGA
TCACGCGTAGACCAACGGC -> CACGCGTAGACCAACGGCT
AAGCATAAAAACCCTGTGT -> AGCATAAAAACCCTGTGTG
ACGAGCTTAACACGTGGAT -> CGAGCTTAACACGTGGATC
TGGTCGGTTTCGTGCCAAA -> GGTCGGTTTCGTGCCAAAC
ATACTCAATACCAGCCTAA -> TACTCAATACCAGCCTAAT
TGAGCCTCCACTCATCGAT -> GAGCCTCCACTCATCGATA
GGATTTCTCCATGCTTACA -> GATTTCTCCATGCTTACAC
ACTCATAATATGCGGTTTT -> CTCATAATATGCGGTTTTC
CGTAATATCTCGGAAATCT -> GTAATATCTCGGAAATCTC
ATCAGGCACTATACCTGAA -> TCAGGCACTATACCTGAAT
TAGCCCTGGAACCGATACT -> AGCCCTGGAACCGATACTC
GTAGCCCTGGAACCGATAC -> TAGCCCTGGAACCGATACT
AATATCTCGGAAATCTCCC -> ATATCTCGGAAATCTCCCT
GTGTAGATCGGCGGTAAAA -> TGTAGATCGGCGGTAAAAT
TGCTATATGGGTAGGACCC -> GCTATATGGGTAGGACCCC
TTTTAGAGTCACTGGTTAG -> TTTAGAGTCACTGGTTAGC
TGGGATGGTAAAGTTTAAT -> GGGATGGTAAAGTTTAATG
TTCCGGGGATGTTGAGTCA -> TCCGGGGATGTTGAGTCAG
ATCGGACCTATGGCGTCTC -> TCGGACCTATGGCGTCTCA
GCACAGGCACTATACCTGA -> CACAGGCACTATACCTGAA
AGAATTAACGGGGATCTGA -> GAATTAACGGGGATCTGAT
CACGGAGATCGTTGGACTC -> ACGGAGATCGTTGGACTCT
GGTGTGGGCTCGATGCGCA -> GTGTGGGCTCGATGCGCAG
ACTCATCGATAGGATACGG -> CTCATCGATAGGATACGGG
GTCGCACATTCAATTATAT -> TCGCACATTCAATTATATT
CTCTTATGCAGCTTTGCCC -> TCTTATGCAGCTTTGCCCC
ATAACGGCCCATTCTCGTC -> TAACGGCCCATTCTCGTCG
TTTCTCGTAGGAGGAATTG -> TTCTCGTAGGAGGAATTGA
CCCTATCGAGAATGCCGCT -> CCTATCGAGAATGCCGCTC
GTAAATCCGTATTGTACGC -> TAAATCCGTATTGTACGCC
TGGATACGCGAACGGGTTA -> GGATACGCGAACGGGTTAA
TCACTTTACCAGAACGCAC -> CACTTTACCAGAACGCACG
CCATTTTAGAGTCACTGGT -> CATTTTAGAGTCACTGGTT
CGTTGGACCCTATCGAGAA -> GTTGGACCCTATCGAGAAT
CCCAGATCGGACCTATGGC -> CCAGATCGGACCTATGGCG
ATACATAGGAGGGAACCGG -> TACATAGGAGGGAACCGGC
TGGTGTTATCTCGTCGTGG -> GGTGTTATCTCGTCGTGGT
GTGCGGCTCTCGTCGTGGT -> TGCGGCTCTCGTCGTGGTG
GCCGGGCGATGGCTCTGTC -> CCGGGCGATGGCTCTGTCC
TTGCACAAGGTCAGCGTGC -> TGCACAAGGTCAGCGTGCC
GCAGTCTACTGTCTTCGAA -> CAGTCTACTGTCTTCGAAA
CACACAACACGGATGCCGC -> ACACAACACGGATGCCGCA
AGGTCAGCGTGCCACTAGG -> GGTCAGCGTGCCACTAGGC
AATCCAGTATCTGAGCCTC -> ATCCAGTATCTGAGCCTCC
CAGAACACGCGCTGCGATG -> AGAACACGCGCTGCGATGC
AGTGGCACACGTGGATGAC -> GTGGCACACGTGGATGACT
CGAAGCAGCGCGTCTGACG -> GAAGCAGCGCGTCTGACGC
GTTAGCTTATCATAAGGAG -> TTAGCTTATCATAAGGAGT
AATCAGCACGTCTCGCGTT -> ATCAGCACGTCTCGCGTTT
TTGGACTTTCGAATTGTAT -> TGGACTTTCGAATTGTATG
TTGTATGCCCCCGCAACCA -> TGTATGCCCCCGCAACCAT
CGTTTCAGCCTGAATGGGA -> GTTTCAGCCTGAATGGGAG
GACTTTCGAATTGTATGCC -> ACTTTCGAATTGTATGCCC
TATACCTGAATTGGAATGA -> ATACCTGAATTGGAATGAA
ACTTTATCATAAGCATAAA -> CTTTATCATAAGCATAAAA
GCGTGCAGTCTACTGTCTT -> CGTGCAGTCTACTGTCTTC
CGGTTCGTCGGTCATATCG -> GGTTCGTCGGTCATATCGT
CAAACCCATAGAAGTGGAT -> AAACCCATAGAAGTGGATT
GTGGTGTGGGCTCGATGCG -> TGGTGTGGGCTCGATGCGC
GTGTAGTGGCACACGTGGA -> TGTAGTGGCACACGTGGAT
CGTGGTGGGTGTAGTGCGT -> GTGGTGGGTGTAGTGCGTA
GCCGCTCTTGTGGTCGGCG -> CCGCTCTTGTGGTCGGCGG
GTGCCAGTGCCCAGATCGG -> TGCCAGTGCCCAGATCGGA
TACCTGAATTGGAATGAAA -> ACCTGAATTGGAATGAAAC
GTGATTGGCAGACGTCCGG -> TGATTGGCAGACGTCCGGT
CACTGGTTAGCGCTTCCGT -> ACTGGTTAGCGCTTCCGTT
TTATCTGGATTTCTCCATG -> TATCTGGATTTCTCCATGC
TATCGTCACACCGCCCTGC -> ATCGTCACACCGCCCTGCT
CATTTTGGGTCATCCATTG -> ATTTTGGGTCATCCATTGG
TGTATGGGATGGTAAAGTT -> GTATGGGATGGTAAAGTTT
TGTACCAACCGAAAGCACA -> GTACCAACCGAAAGCACAT
GCTTGCCACTCGGTTCGTC -> CTTGCCACTCGGTTCGTCG
CCTTTTCTATCGCTGTTCG -> CTTTTCTATCGCTGTTCGC
CGAAAGACCGTAATATCTC -> GAAAGACCGTAATATCTCG
TCAGGATGCGTGCAGTCTA -> CAGGATGCGTGCAGTCTAC
GGCGGTATCTAAGCGAACG -> GCGGTATCTAAGCGAACGA
GCGTGATTGGCAGACGTCC -> CGTGATTGGCAGACGTCCG
TCTCGCGTTTTTTATATAA -> CTCGCGTTTTTTATATAAT
GGCGTCTCAGTCTTAAAGC -> GCGTCTCAGTCTTAAAGCC
AGGCTCCAGAACACGCGCT -> GGCTCCAGAACACGCGCTG
ACGGGTCACTGAATTTTTG -> CGGGTCACTGAATTTTTGT
TCAGCCTGAATGGGAGCAT -> CAGCCTGAATGGGAGCATC
GTTCGCCGGTCTTGCACAA -> TTCGCCGGTCTTGCACAAG
ACTGTCTTCGAAAGACCGT -> CTGTCTTCGAAAGACCGTA
TATCTGGATTTCTCCATGC -> ATCTGGATTTCTCCATGCT
GATCCGTTGTCTCCCACTC -> ATCCGTTGTCTCCCACTCC
GCACGTCTCGCGTTTTTTA -> CACGTCTCGCGTTTTTTAT
AGGATACGGGCAGATGCTA -> GGATACGGGCAGATGCTAG
TGAATTGGAATGAAACCTC -> GAATTGGAATGAAACCTCG
TACTTTATCATAAGCATAA -> ACTTTATCATAAGCATAAA
ACACACAACACGGATGCCG -> CACACAACACGGATGCCGC
TAGAACTAGTCCCCAGTGG -> AGAACTAGTCCCCAGTGGA
ACAGGCACTATACCTGAAT -> CAGGCACTATACCTGAATA
CGTTTTTTATATAATCCCT -> GTTTTTTATATAATCCCTC
ACGCTGGTGTAAATCCGTA -> CGCTGGTGTAAATCCGTAT
CCTAATACGTTGGACCCTA -> CTAATACGTTGGACCCTAT
ATCACGCGTAGACCAACGG -> TCACGCGTAGACCAACGGC
TCACTTGTTAGCTTATCAT -> CACTTGTTAGCTTATCATA
GCACTATACCTGAATCTAG -> CACTATACCTGAATCTAGT
TGAATAACGGCCCATTCTC -> GAATAACGGCCCATTCTCG
ACGTGATACCATTCGCCGC -> CGTGATACCATTCGCCGCA
ACGCGTCGCCATGTTGCAT -> CGCGTCGCCATGTTGCATT
CTATTCCATAGGCTCCAGA -> TATTCCATAGGCTCCAGAA
AGCGTAGTCCTGCGTTACT -> GCGTAGTCCTGCGTTACTG
CCACTCGGTTCGTCGGTCA -> CACTCGGTTCGTCGGTCAT
ACTATACCTGAATAACGGC -> CTATACCTGAATAACGGCC
CTGCGTTACTGCAGTAGCA -> TGCGTTACTGCAGTAGCAT
CTATACCTGAATAACGGCC -> TATACCTGAATAACGGCCC
TCCGGTATGCCCTAGAAAT -> CCGGTATGCCCTAGAAATA
TGCCATCCCATATACATAG -> GCCATCCCATATACATAGG
ATATTGATTCTAGTGCCAG -> TATTGATTCTAGTGCCAGT
TATTCTGCTCTAGAACTAG -> ATTCTGCTCTAGAACTAGT
CAGGAGGGGCGGGTCAATC -> AGGAGGGGCGGGTCAATCA
AGGACCCCCTAGTCTCACT -> GGACCCCCTAGTCTCACTT
GAAAATGCATTAAGGTCGC -> AAAATGCATTAAGGTCGCC
ACATTCAATTATATTCTGC -> CATTCAATTATATTCTGCT
CGTACATGCGCGTGGTGTG -> GTACATGCGCGTGGTGTGG
ATATACATAGGAGGGAACC -> TATACATAGGAGGGAACCG
GCGGTTTTCTCGTAGGAGG -> CGGTTTTCTCGTAGGAGGA
CAGCACGTCTCGCGTTTTT -> AGCACGTCTCGCGTTTTTT
GTTGTCTCCCACTCCAGGC -> TTGTCTCCCACTCCAGGCT
AGGTCATGCGATCCCGGAC -> GGTCATGCGATCCCGGACT
TATCTGTGTACCAACCGAA -> ATCTGTGTACCAACCGAAA
ACGACACACAACACGGATG -> CGACACACAACACGGATGC
CTCGTAGCCCTGGAACCGA -> TCGTAGCCCTGGAACCGAT
GAACGCCCAGGCACTATAC -> AACGCCCAGGCACTATACC
AGTGGATTGCGGATGAGCA -> GTGGATTGCGGATGAGCAA
CTGAGACGTGATACCATTC -> TGAGACGTGATACCATTCG
CCTTGGCTACGAAGCAGCG -> CTTGGCTACGAAGCAGCGC
TTCCGTTCCGTTTCAGCCT -> TCCGTTCCGTTTCAGCCTG
ATACCCGGCTAGTTCCTTT -> TACCCGGCTAGTTCCTTTT
AGTTTTTAGACGACACACA -> GTTTTTAGACGACACACAA
CTTGCCACTCGGTTCGTCG -> TTGCCACTCGGTTCGTCGG
GCTCACGCGAACGGGTCAC -> CTCACGCGAACGGGTCACT
CCAGTGCCCAGATCGGACC -> CAGTGCCCAGATCGGACCT
TCTAACTTTATCTGGATTT -> CTAACTTTATCTGGATTTC
CATAGAAGTGGATTGCGGA -> ATAGAAGTGGATTGCGGAT
CACGTCGCACATTCAATTA -> ACGTCGCACATTCAATTAT
ATACGTTGGACCCTATCGA -> TACGTTGGACCCTATCGAG
GGTTCGTCGGTCATATCGT -> GTTCGTCGGTCATATCGTC
GAGGAATTGACCGAACTGT -> AGGAATTGACCGAACTGTT
GCATAAAAACCCTGTGTGA -> CATAAAAACCCTGTGTGAA
TCCAGGCTGCTGGGCACTC -> CCAGGCTGCTGGGCACTCG
CACATCCACGGAGATCGTT -> ACATCCACGGAGATCGTTG
TCCATGCTTACACGGGAAG -> CCATGCTTACACGGGAAGC
TGAAGGATCACCAACCAGC -> GAAGGATCACCAACCAGCT
CTGACGCTGGTGTAAATCC -> TGACGCTGGTGTAAATCCG
TATTGACGAGTCCCAGGGT -> ATTGACGAGTCCCAGGGTA
CTCATAATATGCGGTTTTC -> TCATAATATGCGGTTTTCT
CGTGCCAAACCCATAGAAG -> GTGCCAAACCCATAGAAGT
ATACCGTAAACTCTCTAGC -> TACCGTAAACTCTCTAGCG
GCACTATACCTGAATAACG -> CACTATACCTGAATAACGG
AACGGGGATCTGATTAGAG -> ACGGGGATCTGATTAGAGT
TGCGTGATTGGCAGACGTC -> GCGTGATTGGCAGACGTCC
TTCGCCGCACTGATACGTG -> TCGCCGCACTGATACGTGA
TGTGGTCGGCGGCACGCGG -> GTGGTCGGCGGCACGCGGG
CCTGAATTGGAATGAAACC -> CTGAATTGGAATGAAACCT
GTCGCCATGTTGCATTGGT -> TCGCCATGTTGCATTGGTT
AGTGCGTAGTTTTTAGACG -> GTGCGTAGTTTTTAGACGA
TAGGTAGTGATGACTTGTA -> AGGTAGTGATGACTTGTAC
GTCAGTGCGTGATTGGCAG -> TCAGTGCGTGATTGGCAGA
AACCGGCTATTCGAGTAGG -> ACCGGCTATTCGAGTAGGT
AGAATGCCGCTCTTGTGGT -> GAATGCCGCTCTTGTGGTC
CTCTCGTCGTGGTGGGTGT -> TCTCGTCGTGGTGGGTGTA
CACGTGGATGACTATCTGT -> ACGTGGATGACTATCTGTG
GGCGGTAAAATGAACTCGT -> GCGGTAAAATGAACTCGTG
TCGTGGTGGGTGTAGTGGC -> CGTGGTGGGTGTAGTGGCA
CAATACCAGCCTAATACGT -> AATACCAGCCTAATACGTT
AGAAATATTGATTCTAGTG -> GAAATATTGATTCTAGTGC
CGAGCCTCAGGATGCGTGC -> GAGCCTCAGGATGCGTGCA
GTATCTAAGCGAACGAGTG -> TATCTAAGCGAACGAGTGG
AACGGGTTAATACCGTAAA -> ACGGGTTAATACCGTAAAC
GGCGGCACGCGGGGAGCGT -> GCGGCACGCGGGGAGCGTA
ACGTACATGCGCGTGGTGT -> CGTACATGCGCGTGGTGTG
TGCCTAAGAATTAACGGGG -> GCCTAAGAATTAACGGGGA
CGTGGTGGGTGTAGACTGC -> GTGGTGGGTGTAGACTGCG
ATTGTACGCCTGCTATATG -> TTGTACGCCTGCTATATGG
ATATCGTCACACCGCCCTG -> TATCGTCACACCGCCCTGC
GGCGGGTCAATCAGCACGT -> GCGGGTCAATCAGCACGTC
GGGATCTGATTAGAGTGAC -> GGATCTGATTAGAGTGACT
CGTTACTGCAGTAGCATTC -> GTTACTGCAGTAGCATTCA
GAAGTGGATTGCGGATGAG -> AAGTGGATTGCGGATGAGC
ATTTGTGACCAACACACTA -> TTTGTGACCAACACACTAG
TTTTTAGACGACACACAAC -> TTTTAGACGACACACAACA
ATGCCTAAGAATTAACGGG -> TGCCTAAGAATTAACGGGG
ATCGCTGTTCGCCGGTCTT -> TCGCTGTTCGCCGGTCTTG
GGCTTTGCCTCGTTGAGCC -> GCTTTGCCTCGTTGAGCCG
GTGTGCGTTATTATTGACG -> TGTGCGTTATTATTGACGA
GTGATGACTTGTACTACCG -> TGATGACTTGTACTACCGG
GCCCCCGCAACCATACGTC -> CCCCCGCAACCATACGTCG
ATTGGACTTTCGAATTGTA -> TTGGACTTTCGAATTGTAT
GTACGCCTGCTATATGGGT -> TACGCCTGCTATATGGGTA
ACCTGAATAACGGCCCATT -> CCTGAATAACGGCCCATTC
GCCATTTTAGAGTCACTGG -> CCATTTTAGAGTCACTGGT
AGCGCGTTAGTAGCACAGA -> GCGCGTTAGTAGCACAGAA
TCGATCAATTTTTGGGTGG -> CGATCAATTTTTGGGTGGG
GAACTAGTCCCCAGTGGAT -> AACTAGTCCCCAGTGGATA
TTCCGTTTCAGCCTGAATG -> TCCGTTTCAGCCTGAATGG
CTGAATTTTTGTGTAGATC -> TGAATTTTTGTGTAGATCG
CACGCGGGGAGCGTAGTCC -> ACGCGGGGAGCGTAGTCCT
TCGGTAATCCACGCGTCGC -> CGGTAATCCACGCGTCGCC
ATATGGGTAGGACCCCCTA -> TATGGGTAGGACCCCCTAG
GAGCGTAGTCCTGCGTTAC -> AGCGTAGTCCTGCGTTACT
TTGCGACAATTTGTGACCA -> TGCGACAATTTGTGACCAA
GATTAGAGTGACTTTGGCT -> ATTAGAGTGACTTTGGCTC
ATTATATTCTGCTCTAGAA -> TTATATTCTGCTCTAGAAC
TTCCGCAGTCTCAACTTGA -> TCCGCAGTCTCAACTTGAC
AGTCTCAACTTGACGAGCT -> GTCTCAACTTGACGAGCTT
CCCTCGATCAATTTTTGGG -> CCTCGATCAATTTTTGGGT
TAGATCGGCGGTAAAATGA -> AGATCGGCGGTAAAATGAA
CCGCAGTCTCAACTTGACG -> CGCAGTCTCAACTTGACGA
CCCGGCTAGTTCCTTTTCT -> CCGGCTAGTTCCTTTTCTA
TTAAAGCCTAATGGGTCGC -> TAAAGCCTAATGGGTCGCC
CGCTGCCATCCCATATACA -> GCTGCCATCCCATATACAT
CCAACACACTAGTAGGCAC -> CAACACACTAGTAGGCACA
AGGTAGTGATGACTTGTAC -> GGTAGTGATGACTTGTACT
GGTCATGCGATCCCGGACT -> GTCATGCGATCCCGGACTG
CGGTAAAATGAACTCGTGT -> GGTAAAATGAACTCGTGTG
GCACACGTGGATGACTATC -> CACACGTGGATGACTATCT
CACTATACCTGAATAACGG -> ACTATACCTGAATAACGGC
GTTAGCGCTTCCGTTCCGT -> TTAGCGCTTCCGTTCCGTT
TATCGCTGTTCGCCGGTCT -> ATCGCTGTTCGCCGGTCTT
GCGCTGCGATGCCTAAGAA -> CGCTGCGATGCCTAAGAAT
CACCGCCCTGCTGTTCCGG -> ACCGCCCTGCTGTTCCGGG
CCCTCACTTCCGCAGTCTC -> CCTCACTTCCGCAGTCTCA
TTTATTACGGTAACGCGAT -> TTATTACGGTAACGCGATA
TAAGGAGTCCACTCATACC -> AAGGAGTCCACTCATACCG
ATCTGAGCCTCCACTCATC -> TCTGAGCCTCCACTCATCG
CGTGGATGACTATCTGTGT -> GTGGATGACTATCTGTGTA
TCTTATGCAGCTTTGCCCC -> CTTATGCAGCTTTGCCCCA
ATCGTCACACCGCCCTGCT -> TCGTCACACCGCCCTGCTG
CCTGAATCTAGTGCGGCTC -> CTGAATCTAGTGCGGCTCT
ACCCCCTAGTCTCACTTGT -> CCCCCTAGTCTCACTTGTT
CACGTCTCGCGTTTTTTAT -> ACGTCTCGCGTTTTTTATA
GGTGGGTGTAGTGGCACAC -> GTGGGTGTAGTGGCACACG
TTTTTGGGTGGGCTTTGCC -> TTTTGGGTGGGCTTTGCCT
GGGTGTCGCGAACGTGGAG -> GGTGTCGCGAACGTGGAGA
TTACTGCAGTAGCATTCAC -> TACTGCAGTAGCATTCACT
AGCACATCCACGGAGATCG -> GCACATCCACGGAGATCGT
AACCATACGTCGTTTCCCT -> ACCATACGTCGTTTCCCTC
GTTTCGTGCCAAACCCATA -> TTTCGTGCCAAACCCATAG
ACCAACCAGCTTGCCACTC -> CCAACCAGCTTGCCACTCG
AACTGTTTCCCTTTGCGAC -> ACTGTTTCCCTTTGCGACA
CAATTTGTGACCAACACAC -> AATTTGTGACCAACACACT
GATCACCAACCAGCTTGCC -> ATCACCAACCAGCTTGCCA
TGGGTGGGCTTTGCCTCGT -> GGGTGGGCTTTGCCTCGTT
GACAATACGAATTACTTGG -> ACAATACGAATTACTTGGT
CAAAAAATACCCGGCTAGT -> AAAAAATACCCGGCTAGTT
TGATTGGCAGACGTCCGGT -> GATTGGCAGACGTCCGGTA
ACCTCGTCGTGGTGGGTGT -> CCTCGTCGTGGTGGGTGTA
TCGGCGGCACGCGGGGAGC -> CGGCGGCACGCGGGGAGCG
ATTAGAGTGACTTTGGCTC -> TTAGAGTGACTTTGGCTCA
TGGCTACGAAGCAGCGCGT -> GGCTACGAAGCAGCGCGTC
TAGGACCCCCTAGTCTCAC -> AGGACCCCCTAGTCTCACT
CTTATGCAGCTTTGCCCCA -> TTATGCAGCTTTGCCCCAT
TCCACTCATACCGAGACAA -> CCACTCATACCGAGACAAA
GGTAGTGATGACTTGTACT -> GTAGTGATGACTTGTACTA
GGTAAAATGAACTCGTGTG -> GTAAAATGAACTCGTGTGC
ATGCATTAAGGTCGCCGGG -> TGCATTAAGGTCGCCGGGC
CTTATCATAAGGAGTCCAC -> TTATCATAAGGAGTCCACT
AGTGACTTTGGCTCACGCG -> GTGACTTTGGCTCACGCGA
ACTAGTAGGCACAGGCACT -> CTAGTAGGCACAGGCACTA
TCCCTCATCTAACTTTATC -> CCCTCATCTAACTTTATCT
GTTGCATTGGTTATAGAAA -> TTGCATTGGTTATAGAAAC
AACCGAAAGCACATCCACG -> ACCGAAAGCACATCCACGG
ACGGTAACGCGATAATGCC -> CGGTAACGCGATAATGCCA
CACGCGTAGACCAACGGCT -> ACGCGTAGACCAACGGCTG
TTGGGTCATCCATTGGACT -> TGGGTCATCCATTGGACTT
GCTGCCATCCCATATACAT -> CTGCCATCCCATATACATA
CCGCTCTTGTGGTCGGCGG -> CGCTCTTGTGGTCGGCGGC
CCACGGAGATCGTTGGACT -> CACGGAGATCGTTGGACTC
ACCAGCTTGCCACTCGGTT -> CCAGCTTGCCACTCGGTTC
CAGCGTGCCACTAGGCGAA -> AGCGTGCCACTAGGCGAAC
TATCGAGAATGCCGCTCTT -> ATCGAGAATGCCGCTCTTG
TCCCTCGATCAATTTTTGG -> CCCTCGATCAATTTTTGGG
TGTGTGAAGTCGGTAATCC -> GTGTGAAGTCGGTAATCCA
TGATACGTGAAGGATCACC -> GATACGTGAAGGATCACCA
ATCCCTCCCTCACTTCCGC -> TCCCTCCCTCACTTCCGCA
TGGGTGCAGGCACTATACC -> GGGTGCAGGCACTATACCT
TCTCCCACTCCAGGCTGCT -> CTCCCACTCCAGGCTGCTG
AACGCGATAATGCCATTTT -> ACGCGATAATGCCATTTTA
GCACATCCACGGAGATCGT -> CACATCCACGGAGATCGTT
GATACGGGCAGATGCTAGC -> ATACGGGCAGATGCTAGCA
TGTAGTGGCACACGTGGAT -> GTAGTGGCACACGTGGATG
TAGTTCCTTTTCTATCGCT -> AGTTCCTTTTCTATCGCTG
TGCAGTCTACTGTCTTCGA -> GCAGTCTACTGTCTTCGAA
CAATCAGCACGTCTCGCGT -> AATCAGCACGTCTCGCGTT
CGCCGGGCGATGGCTCTGT -> GCCGGGCGATGGCTCTGTC
ACTCAATACCAGCCTAATA -> CTCAATACCAGCCTAATAC
CCTTTGCGACAATTTGTGA -> CTTTGCGACAATTTGTGAC
GGTGCAGGCACTATACCTG -> GTGCAGGCACTATACCTGA
ATCTCCCTCATCTAACTTT -> TCTCCCTCATCTAACTTTA
GCGAACGAGTGGGTGCAGG -> CGAACGAGTGGGTGCAGGC
AATGCCGCTCTTGTGGTCG -> ATGCCGCTCTTGTGGTCGG
CAGAACGCACGTCGCACAT -> AGAACGCACGTCGCACATT
ACTTGACGAGCTTAACACG -> CTTGACGAGCTTAACACGT
TTCCCTTTGCGACAATTTG -> TCCCTTTGCGACAATTTGT
TGACTTTGGCTCACGCGAA -> GACTTTGGCTCACGCGAAC
TGTTCCATACGCAGTGGGG -> GTTCCATACGCAGTGGGGC
CGGCCCATTCTCGTCGTGG -> GGCCCATTCTCGTCGTGGT
ACGCGAACGGGTCACTGAA -> CGCGAACGGGTCACTGAAT
ACTGCCGACAATACGAATT -> CTGCCGACAATACGAATTA
ATAGAAACGGTAGCACGAG -> TAGAAACGGTAGCACGAGA
CCACTCATACCGAGACAAA -> CACTCATACCGAGACAAAT
ACTCGTAGCCCTGGAACCG -> CTCGTAGCCCTGGAACCGA
AACCTCGTCGTGGTGGGTG -> ACCTCGTCGTGGTGGGTGT
CGAAAGCACATCCACGGAG -> GAAAGCACATCCACGGAGA
TTTAGACGACACACAACAC -> TTAGACGACACACAACACG
AACGGCCCATTCTCGTCGT -> ACGGCCCATTCTCGTCGTG
TATAGAAACGGTAGCACGA -> ATAGAAACGGTAGCACGAG
GCCGCAGCGAGGTCATGCG -> CCGCAGCGAGGTCATGCGA
TAAAGCCTAATGGGTCGCC -> AAAGCCTAATGGGTCGCCA
GGTCGCCAACGATTGTATG -> GTCGCCAACGATTGTATGG
GGTCGTGGCGCCCCGGGTG -> GTCGTGGCGCCCCGGGTGT
GCACTGATACGTGAAGGAT -> CACTGATACGTGAAGGATC
GACCGGATCACGCGTAGAC -> ACCGGATCACGCGTAGACC
TAAGACCACTCATAATATG -> AAGACCACTCATAATATGC
CTATACCTGAATTGGAATG -> TATACCTGAATTGGAATGA
CGTAGACCAACGGCTGATC -> GTAGACCAACGGCTGATCC
GTGTAGACTGCGCATTTAT -> TGTAGACTGCGCATTTATT
CCCATATACATAGGAGGGA -> CCATATACATAGGAGGGAA
GCGTCGCCATGTTGCATTG -> CGTCGCCATGTTGCATTGG
ACAGAATAAGACCACTCAT -> CAGAATAAGACCACTCATA
TAGGCGAACGCCCAGGCAC -> AGGCGAACGCCCAGGCACT
CATCAGGCACTATACCTGA -> ATCAGGCACTATACCTGAA
TTGAGTCAGTGCGTGATTG -> TGAGTCAGTGCGTGATTGG
GCGAGGTCATGCGATCCCG -> CGAGGTCATGCGATCCCGG
TGGGTGTAGCGCTGCCATC -> GGGTGTAGCGCTGCCATCC
AGAAGCTATTCCATAGGCT -> GAAGCTATTCCATAGGCTC
ATTAACGGGGATCTGATTA -> TTAACGGGGATCTGATTAG
ATAGGCTCCAGAACACGCG -> TAGGCTCCAGAACACGCGC
GCGTAGTCCTGCGTTACTG -> CGTAGTCCTGCGTTACTGC
GCGAACGCCCAGGCACTAT -> CGAACGCCCAGGCACTATA
GCGGTAAAATGAACTCGTG -> CGGTAAAATGAACTCGTGT
TCTCCCTCATCTAACTTTA -> CTCCCTCATCTAACTTTAT
TTACACATCAGGCACTATA -> TACACATCAGGCACTATAC
CGCAGTGGGGCGGTATCTA -> GCAGTGGGGCGGTATCTAA
CTATCGAGAATGCCGCTCT -> TATCGAGAATGCCGCTCTT
GAATTGACCGAACTGTTTC -> AATTGACCGAACTGTTTCC
CGTGGCTTTCTCAACGTAC -> GTGGCTTTCTCAACGTACT
GGGAACCGGCTATTCGAGT -> GGAACCGGCTATTCGAGTA
TCTGACGCTGGTGTAAATC -> CTGACGCTGGTGTAAATCC
AAAAATACCCGGCTAGTTC -> AAAATACCCGGCTAGTTCC
CGGTATCTAAGCGAACGAG -> GGTATCTAAGCGAACGAGT
ACGGATGCCGCAGCGAGGT -> CGGATGCCGCAGCGAGGTC
GCCAAACCCATAGAAGTGG -> CCAAACCCATAGAAGTGGA
AGAACACGCGCTGCGATGC -> GAACACGCGCTGCGATGCC
ATCCGTTGTCTCCCACTCC -> TCCGTTGTCTCCCACTCCA
ACCGGCTATTCGAGTAGGT -> CCGGCTATTCGAGTAGGTA
GGACTTTCGAATTGTATGC -> GACTTTCGAATTGTATGCC
GGAGCGTAGTCCTGCGTTA -> GAGCGTAGTCCTGCGTTAC
GCCAGTGCCCAGATCGGAC -> CCAGTGCCCAGATCGGACC
AACCGATACTCAATACCAG -> ACCGATACTCAATACCAGC
ACTGAGACGTGATACCATT -> CTGAGACGTGATACCATTC
CAACCATACGTCGTTTCCC -> AACCATACGTCGTTTCCCT
CCATACGTCGTTTCCCTCG -> CATACGTCGTTTCCCTCGA
CACGCGAACGGGTCACTGA -> ACGCGAACGGGTCACTGAA
TACACATCAGGCACTATAC -> ACACATCAGGCACTATACC
TCTCAACTTGACGAGCTTA -> CTCAACTTGACGAGCTTAA
AAGCAGCGCGTCTGACGCT -> AGCAGCGCGTCTGACGCTG
TTATTATTGACGAGTCCCA -> TATTATTGACGAGTCCCAG
CCCGGGTGTCGCGAACGTG -> CCGGGTGTCGCGAACGTGG
TCTCTAGCGACTGCCGACA -> CTCTAGCGACTGCCGACAA
CCAACCGAAAGCACATCCA -> CAACCGAAAGCACATCCAC
GATGACTATCTGTGTACCA -> ATGACTATCTGTGTACCAA
GTCTTAAAGCCTAATGGGT -> TCTTAAAGCCTAATGGGTC
CAGTGCCCAGATCGGACCT -> AGTGCCCAGATCGGACCTA
CAGCGCGTCTGACGCTGGT -> AGCGCGTCTGACGCTGGTG
TCAGTGCGTGATTGGCAGA -> CAGTGCGTGATTGGCAGAC
CGCTGCGATGCCTAAGAAT -> GCTGCGATGCCTAAGAATT
CGCCCAGGCACTATACCTG -> GCCCAGGCACTATACCTGA
TGGGTGTAGTGCGTAGTTT -> GGGTGTAGTGCGTAGTTTT
TAATGCCATTTTAGAGTCA -> AATGCCATTTTAGAGTCAC
TCGCGAACGTGGAGAATCC -> CGCGAACGTGGAGAATCCA
TCAGGCACTATACCTGAAT -> CAGGCACTATACCTGAATT
CGTCTCAGTCTTAAAGCCT -> GTCTCAGTCTTAAAGCCTA
CGCGTTTTTTATATAATCC -> GCGTTTTTTATATAATCCC
CAGTCTCAACTTGACGAGC -> AGTCTCAACTTGACGAGCT
GCATTAAGGTCGCCGGGCG -> CATTAAGGTCGCCGGGCGA
GGAGTCCACTCATACCGAG -> GAGTCCACTCATACCGAGA
CGTATTGTACGCCTGCTAT -> GTATTGTACGCCTGCTATA
TCCATTGGACTTTCGAATT -> CCATTGGACTTTCGAATTG
GACGAGCTTAACACGTGGA -> ACGAGCTTAACACGTGGAT
GTGGCTTTCTCAACGTACT -> TGGCTTTCTCAACGTACTT
GTCTACTGTCTTCGAAAGA -> TCTACTGTCTTCGAAAGAC
GGTTAGCGCTTCCGTTCCG -> GTTAGCGCTTCCGTTCCGT
GGAGGGGCGGGTCAATCAG -> GAGGGGCGGGTCAATCAGC
CGCATTTATTACGGTAACG -> GCATTTATTACGGTAACGC
CAATTTTTGGGTGGGCTTT -> AATTTTTGGGTGGGCTTTG
GCACGTACATGCGCGTGGT -> CACGTACATGCGCGTGGTG
AGCATCAGGAGGGGCGGGT -> GCATCAGGAGGGGCGGGTC
AAGCTATTCCATAGGCTCC -> AGCTATTCCATAGGCTCCA
CTATCGCTGTTCGCCGGTC -> TATCGCTGTTCGCCGGTCT
CAGTGCGTGATTGGCAGAC -> AGTGCGTGATTGGCAGACG
ATATGCGGTTTTCTCGTAG -> TATGCGGTTTTCTCGTAGG
CAGCTTTGCCCCATTTTGG -> AGCTTTGCCCCATTTTGGG
CCCCATTTTGGGTCATCCA -> CCCATTTTGGGTCATCCAT
ATACGTCGTTTCCCTCGAT -> TACGTCGTTTCCCTCGATC
TCCCCAGTGGATACGCGAA -> CCCCAGTGGATACGCGAAC
CTCGCGTTTTTTATATAAT -> TCGCGTTTTTTATATAATC
GGGGAGCGTAGTCCTGCGT -> GGGAGCGTAGTCCTGCGTT
TCTGTGTACCAACCGAAAG -> CTGTGTACCAACCGAAAGC
GGAACCGGCTATTCGAGTA -> GAACCGGCTATTCGAGTAG
CTGTTCCGGGGATGTTGAG -> TGTTCCGGGGATGTTGAGT
CGCCATGTTGCATTGGTTA -> GCCATGTTGCATTGGTTAT
GCTGTTCCGGGGATGTTGA -> CTGTTCCGGGGATGTTGAG
CCAGAACACGCGCTGCGAT -> CAGAACACGCGCTGCGATG
TCGCCGCACTGATACGTGA -> CGCCGCACTGATACGTGAA
AGGAGTCCACTCATACCGA -> GGAGTCCACTCATACCGAG
GCACGCGGGGAGCGTAGTC -> CACGCGGGGAGCGTAGTCC
AGACGTGATACCATTCGCC -> GACGTGATACCATTCGCCG
CTGGTTAGCGCTTCCGTTC -> TGGTTAGCGCTTCCGTTCC
TCGAGCCTCAGGATGCGTG -> CGAGCCTCAGGATGCGTGC
ATGCCCTAGAAATATTGAT -> TGCCCTAGAAATATTGATT
TGCGATCCCGGACTGGTCG -> GCGATCCCGGACTGGTCGT
CTGAATTGGAATGAAACCT -> TGAATTGGAATGAAACCTC
TGGTGGGTGTAGTGGCACA -> GGTGGGTGTAGTGGCACAC
CTGAATAACGGCCCATTCT -> TGAATAACGGCCCATTCTC
CTCCCACTCCAGGCTGCTG -> TCCCACTCCAGGCTGCTGG
GATATCTTACACATCAGGC -> ATATCTTACACATCAGGCA
TTGGTCGGTTTCGTGCCAA -> TGGTCGGTTTCGTGCCAAA
TTGTATGGGATGGTAAAGT -> TGTATGGGATGGTAAAGTT
ACCTGAATCTAGTGCGGCT -> CCTGAATCTAGTGCGGCTC
TTAACGGGGATCTGATTAG -> TAACGGGGATCTGATTAGA
ATGTTGCATTGGTTATAGA -> TGTTGCATTGGTTATAGAA
TGGTGTAAATCCGTATTGT -> GGTGTAAATCCGTATTGTA
TTAATGTTCCATACGCAGT -> TAATGTTCCATACGCAGTG
GCGATCCCGGACTGGTCGT -> CGATCCCGGACTGGTCGTG
ACGGAGATCGTTGGACTCT -> CGGAGATCGTTGGACTCTT
AGATCGTTGGACTCTTATG -> GATCGTTGGACTCTTATGC
CTGTCCATCCTTGGCTACG -> TGTCCATCCTTGGCTACGA
GCGTGGTGTGGGCTCGATG -> CGTGGTGTGGGCTCGATGC
GCCAACGATTGTATGGGAT -> CCAACGATTGTATGGGATG
TCTGAGCCTCCACTCATCG -> CTGAGCCTCCACTCATCGA
TATACATAGGAGGGAACCG -> ATACATAGGAGGGAACCGG
CTTCGAAAGACCGTAATAT -> TTCGAAAGACCGTAATATC
CGACAATTTGTGACCAACA -> GACAATTTGTGACCAACAC
ACTCTCTAGCGACTGCCGA -> CTCTCTAGCGACTGCCGAC
TTATTACGGTAACGCGATA -> TATTACGGTAACGCGATAA
CCCCCTAGTCTCACTTGTT -> CCCCTAGTCTCACTTGTTA
GCAGCGCGTCTGACGCTGG -> CAGCGCGTCTGACGCTGGT
GATACGCGAACGGGTTAAT -> ATACGCGAACGGGTTAATA
TCAATTTTTGGGTGGGCTT -> CAATTTTTGGGTGGGCTTT
CGTGGAGAATCCAGTATCT -> GTGGAGAATCCAGTATCTG
GCCATGTTGCATTGGTTAT -> CCATGTTGCATTGGTTATA
CGCTGGTGTAAATCCGTAT -> GCTGGTGTAAATCCGTATT
ACGCCTGCTATATGGGTAG -> CGCCTGCTATATGGGTAGG
TGGGCTTTGCCTCGTTGAG -> GGGCTTTGCCTCGTTGAGC
CAGCCTGAATGGGAGCATC -> AGCCTGAATGGGAGCATCA
TATTGATTCTAGTGCCAGT -> ATTGATTCTAGTGCCAGTG
TGAGTCAGTGCGTGATTGG -> GAGTCAGTGCGTGATTGGC
ACTGCGCATTTATTACGGT -> CTGCGCATTTATTACGGTA
TACCTGAATAACGGCCCAT -> ACCTGAATAACGGCCCATT
CTAATGGGTCGCCAACGAT -> TAATGGGTCGCCAACGATT
CGTGGTGGGTGTAGCGCTG -> GTGGTGGGTGTAGCGCTGC
TAGTGCGTAGTTTTTAGAC -> AGTGCGTAGTTTTTAGACG
AGCGTGGCTTTCTCAACGT -> GCGTGGCTTTCTCAACGTA
ATCGAGCCTCAGGATGCGT -> TCGAGCCTCAGGATGCGTG
GTTGGACTCTTATGCAGCT -> TTGGACTCTTATGCAGCTT
CAGGATGCGTGCAGTCTAC -> AGGATGCGTGCAGTCTACT
CACACCGCCCTGCTGTTCC -> ACACCGCCCTGCTGTTCCG
GGTCAGCGTGCCACTAGGC -> GTCAGCGTGCCACTAGGCG
ACGCCCAGGCACTATACCT -> CGCCCAGGCACTATACCTG
GACCACTCATAATATGCGG -> ACCACTCATAATATGCGGT
TGCCATTTTAGAGTCACTG -> GCCATTTTAGAGTCACTGG
GATGCTAGCACGTACATGC -> ATGCTAGCACGTACATGCG
GGGTGTAGTGCGTAGTTTT -> GGTGTAGTGCGTAGTTTTT
GTGGGTGTAGACTGCGCAT -> TGGGTGTAGACTGCGCATT
AGCGCTGCCATCCCATATA -> GCGCTGCCATCCCATATAC
CGCGTTAGTAGCACAGAAT -> GCGTTAGTAGCACAGAATA
GGAAGCGCGTTAGTAGCAC -> GAAGCGCGTTAGTAGCACA
CAACCAGCTTGCCACTCGG -> AACCAGCTTGCCACTCGGT
AACGTACTTTATCATAAGC -> ACGTACTTTATCATAAGCA
ATGACTTGTACTACCGGAT -> TGACTTGTACTACCGGATA
ATATAATCCCTCCCTCACT -> TATAATCCCTCCCTCACTT
ACGCGTAGACCAACGGCTG -> CGCGTAGACCAACGGCTGA
ACGCGGGGAGCGTAGTCCT -> CGCGGGGAGCGTAGTCCTG
CTAGCGACTGCCGACAATA -> TAGCGACTGCCGACAATAC
CTAGGCGAACGCCCAGGCA -> TAGGCGAACGCCCAGGCAC
GAATAAGACCACTCATAAT -> AATAAGACCACTCATAATA
TGGTGTGGGCTCGATGCGC -> GGTGTGGGCTCGATGCGCA
CGTCTCGCGTTTTTTATAT -> GTCTCGCGTTTTTTATATA
ACACGCGCTGCGATGCCTA -> CACGCGCTGCGATGCCTAA
TAGAGTGACTTTGGCTCAC -> AGAGTGACTTTGGCTCACG
CGTTTCCCTCGATCAATTT -> GTTTCCCTCGATCAATTTT
AGCTTTGCCCCATTTTGGG -> GCTTTGCCCCATTTTGGGT
ATATCTCGGAAATCTCCCT -> TATCTCGGAAATCTCCCTC
CTTACACATCAGGCACTAT -> TTACACATCAGGCACTATA
TCGTGGTGGGTGTAGTGCG -> CGTGGTGGGTGTAGTGCGT
CTATGGCGTCTCAGTCTTA -> TATGGCGTCTCAGTCTTAA
GATGCGTGCAGTCTACTGT -> ATGCGTGCAGTCTACTGTC
GCCTGCTATATGGGTAGGA -> CCTGCTATATGGGTAGGAC
TGCCAGTGCCCAGATCGGA -> GCCAGTGCCCAGATCGGAC
GAACGGGTCACTGAATTTT -> AACGGGTCACTGAATTTTT
GCCTAATGGGTCGCCAACG -> CCTAATGGGTCGCCAACGA
TCGTGGTGGGTGTAGACTG -> CGTGGTGGGTGTAGACTGC
TAATATGCGGTTTTCTCGT -> AATATGCGGTTTTCTCGTA
CGGGGAGCGTAGTCCTGCG -> GGGGAGCGTAGTCCTGCGT
GTATGCCCCCGCAACCATA -> TATGCCCCCGCAACCATAC
ATTTTTGGGTGGGCTTTGC -> TTTTTGGGTGGGCTTTGCC
AAGCACATCCACGGAGATC -> AGCACATCCACGGAGATCG
TTAGAGTGACTTTGGCTCA -> TAGAGTGACTTTGGCTCAC
CCAGCCTAATACGTTGGAC -> CAGCCTAATACGTTGGACC
AGACGTCCGGTATGCCCTA -> GACGTCCGGTATGCCCTAG
ACATCCACGGAGATCGTTG -> CATCCACGGAGATCGTTGG
GATGCCTAAGAATTAACGG -> ATGCCTAAGAATTAACGGG
CCCTGCTGTTCCGGGGATG -> CCTGCTGTTCCGGGGATGT
GTAGGAGGAATTGACCGAA -> TAGGAGGAATTGACCGAAC
ATCATAAGCATAAAAACCC -> TCATAAGCATAAAAACCCT
CGTTGAGCCGGACCGGATC -> GTTGAGCCGGACCGGATCA
TGAATCTAGTGCGGCTCTC -> GAATCTAGTGCGGCTCTCG
AGCGCTTCCGTTCCGTTTC -> GCGCTTCCGTTCCGTTTCA
ACGTACTTTATCATAAGCA -> CGTACTTTATCATAAGCAT
TCGTAGCCCTGGAACCGAT -> CGTAGCCCTGGAACCGATA
GCGACTGCCGACAATACGA -> CGACTGCCGACAATACGAA
TGTTCCGGGGATGTTGAGT -> GTTCCGGGGATGTTGAGTC
ATGGTGTTATCTCGTCGTG -> TGGTGTTATCTCGTCGTGG
CGATGCCTAAGAATTAACG -> GATGCCTAAGAATTAACGG
AACCCATAGAAGTGGATTG -> ACCCATAGAAGTGGATTGC
ACGGGCAGATGCTAGCACG -> CGGGCAGATGCTAGCACGT
GTCGCGAACGTGGAGAATC -> TCGCGAACGTGGAGAATCC
CCATGTTGCATTGGTTATA -> CATGTTGCATTGGTTATAG
GTTAGTAGCACAGAATAAG -> TTAGTAGCACAGAATAAGA
CTGTGTGAAGTCGGTAATC -> TGTGTGAAGTCGGTAATCC
TCGAGAATGCCGCTCTTGT -> CGAGAATGCCGCTCTTGTG
CCGGCTAGTTCCTTTTCTA -> CGGCTAGTTCCTTTTCTAT
CCTCACTTCCGCAGTCTCA -> CTCACTTCCGCAGTCTCAA
AGTGGAGTTGGGTAGAAGC -> GTGGAGTTGGGTAGAAGCT
ATTTCTCCATGCTTACACG -> TTTCTCCATGCTTACACGG
GGACTCTTATGCAGCTTTG -> GACTCTTATGCAGCTTTGC
ACTTTATCTGGATTTCTCC -> CTTTATCTGGATTTCTCCA
ATCCCATATACATAGGAGG -> TCCCATATACATAGGAGGG
TGTTCGCCGGTCTTGCACA -> GTTCGCCGGTCTTGCACAA
ATTGTATGGGATGGTAAAG -> TTGTATGGGATGGTAAAGT
TACTGAGACGTGATACCAT -> ACTGAGACGTGATACCATT
TATCTCGTCGTGGTGGGTG -> ATCTCGTCGTGGTGGGTGT
TTGGACCCTATCGAGAATG -> TGGACCCTATCGAGAATGC
GTTGGGTAGAAGCTATTCC -> TTGGGTAGAAGCTATTCCA
TTTCTCCATGCTTACACGG -> TTCTCCATGCTTACACGGG
CACGAGACAGAAGTGGAGT -> ACGAGACAGAAGTGGAGTT
GGAGGAATTGACCGAACTG -> GAGGAATTGACCGAACTGT
GCGCCCCGGGTGTCGCGAA -> CGCCCCGGGTGTCGCGAAC
GATCGTTGGACTCTTATGC -> ATCGTTGGACTCTTATGCA
GCTATTCCATAGGCTCCAG -> CTATTCCATAGGCTCCAGA
GGGTCAATCAGCACGTCTC -> GGTCAATCAGCACGTCTCG
ATTACTTGGTCGGTTTCGT -> TTACTTGGTCGGTTTCGTG
CTCTTGTGGTCGGCGGCAC -> TCTTGTGGTCGGCGGCACG
CGGTAATCCACGCGTCGCC -> GGTAATCCACGCGTCGCCA
CTTGTGGTCGGCGGCACGC -> TTGTGGTCGGCGGCACGCG
TCGCCGGTCTTGCACAAGG -> CGCCGGTCTTGCACAAGGT
ATTCGCCGCACTGATACGT -> TTCGCCGCACTGATACGTG
CCACGCGTCGCCATGTTGC -> CACGCGTCGCCATGTTGCA
ACCAACCGAAAGCACATCC -> CCAACCGAAAGCACATCCA
TCGTCGTGGTGGGTGTAGT -> CGTCGTGGTGGGTGTAGTG,CGTCGTGGTGGGTGTAGTG
ACCAGAACGCACGTCGCAC -> CCAGAACGCACGTCGCACA
AGCCCTGGAACCGATACTC -> GCCCTGGAACCGATACTCA
GGTCTTGCACAAGGTCAGC -> GTCTTGCACAAGGTCAGCG
GGGTAGGACCCCCTAGTCT -> GGTAGGACCCCCTAGTCTC
TACTACCGGATATCTTACA -> ACTACCGGATATCTTACAC
CTAGCACGTACATGCGCGT -> TAGCACGTACATGCGCGTG
AGGCTGCTGGGCACTCGTA -> GGCTGCTGGGCACTCGTAG
AGTGGGGCGGTATCTAAGC -> GTGGGGCGGTATCTAAGCG
GAATGATGGTGTTATCTCG -> AATGATGGTGTTATCTCGT
TCGTCGTGGTGGGTGTAGA -> CGTCGTGGTGGGTGTAGAC
GTCCTGCGTTACTGCAGTA -> TCCTGCGTTACTGCAGTAG
TCGTCGTGGTGGGTGTAGC -> CGTCGTGGTGGGTGTAGCG
CCGGTATGCCCTAGAAATA -> CGGTATGCCCTAGAAATAT
ATGATGGTGTTATCTCGTC -> TGATGGTGTTATCTCGTCG
GTCACTGAATTTTTGTGTA -> TCACTGAATTTTTGTGTAG
CGCCCTGCTGTTCCGGGGA -> GCCCTGCTGTTCCGGGGAT
GCGTTACTGCAGTAGCATT -> CGTTACTGCAGTAGCATTC
CGAGGTCATGCGATCCCGG -> GAGGTCATGCGATCCCGGA
TAATACCGTAAACTCTCTA -> AATACCGTAAACTCTCTAG
ATCAATTTTTGGGTGGGCT -> TCAATTTTTGGGTGGGCTT
CTGGGCACTCGTAGCCCTG -> TGGGCACTCGTAGCCCTGG
GAACGTGGAGAATCCAGTA -> AACGTGGAGAATCCAGTAT
CTGATTAGAGTGACTTTGG -> TGATTAGAGTGACTTTGGC
AATTATATTCTGCTCTAGA -> ATTATATTCTGCTCTAGAA
CCGTAAACTCTCTAGCGAC -> CGTAAACTCTCTAGCGACT
CACACGTGGATGACTATCT -> ACACGTGGATGACTATCTG
TCTCGGAAATCTCCCTCAT -> CTCGGAAATCTCCCTCATC
GGGTCGCCAACGATTGTAT -> GGTCGCCAACGATTGTATG
GCGGTATCTAAGCGAACGA -> CGGTATCTAAGCGAACGAG
GTTCGTCGGTCATATCGTC -> TTCGTCGGTCATATCGTCA
TCTCAGTCTTAAAGCCTAA -> CTCAGTCTTAAAGCCTAAT
CATTCAATTATATTCTGCT -> ATTCAATTATATTCTGCTC
ACAATTTGTGACCAACACA -> CAATTTGTGACCAACACAC
TCAATACCAGCCTAATACG -> CAATACCAGCCTAATACGT
ATTCTAGTGCCAGTGCCCA -> TTCTAGTGCCAGTGCCCAG
TGGACTCTTATGCAGCTTT -> GGACTCTTATGCAGCTTTG
CCTGGAACCGATACTCAAT -> CTGGAACCGATACTCAATA
TACGCGAACGGGTTAATAC -> ACGCGAACGGGTTAATACC
CCGGACCGGATCACGCGTA -> CGGACCGGATCACGCGTAG
AGTAGCACAGAATAAGACC -> GTAGCACAGAATAAGACCA
GGTGTAGTGCGTAGTTTTT -> GTGTAGTGCGTAGTTTTTA
GACTGGTCGTGGCGCCCCG -> ACTGGTCGTGGCGCCCCGG
GTCGTGGTGGGTGTAGACT -> TCGTGGTGGGTGTAGACTG
ATACGTGAAGGATCACCAA -> TACGTGAAGGATCACCAAC
TGGACCCTATCGAGAATGC -> GGACCCTATCGAGAATGCC
TCAACGTACTTTATCATAA -> CAACGTACTTTATCATAAG
GCGCGTGGTGTGGGCTCGA -> CGCGTGGTGTGGGCTCGAT
ATCGAGAATGCCGCTCTTG -> TCGAGAATGCCGCTCTTGT
GGTTATAGAAACGGTAGCA -> GTTATAGAAACGGTAGCAC
TTTTTGTGTAGATCGGCGG -> TTTTGTGTAGATCGGCGGT
CGGACCGGATCACGCGTAG -> GGACCGGATCACGCGTAGA
TCATAATATGCGGTTTTCT -> CATAATATGCGGTTTTCTC
GATTGTATGGGATGGTAAA -> ATTGTATGGGATGGTAAAG
TTCCATAGGCTCCAGAACA -> TCCATAGGCTCCAGAACAC
TTCAATTATATTCTGCTCT -> TCAATTATATTCTGCTCTA
CACAGAATAAGACCACTCA -> ACAGAATAAGACCACTCAT
GTGCGTTATTATTGACGAG -> TGCGTTATTATTGACGAGT
CGCAGCGTGGCTTTCTCAA -> GCAGCGTGGCTTTCTCAAC
AGCTTAACACGTGGATCGA -> GCTTAACACGTGGATCGAG
CCTGAATGATGGTGTTATC -> CTGAATGATGGTGTTATCT
GACCCCCTAGTCTCACTTG -> ACCCCCTAGTCTCACTTGT
AATAAGACCACTCATAATA -> ATAAGACCACTCATAATAT
CACTAGTAGGCACAGGCAC -> ACTAGTAGGCACAGGCACT
ATGAAACCTCGTCGTGGTG -> TGAAACCTCGTCGTGGTGG
GTGCCACTAGGCGAACGCC -> TGCCACTAGGCGAACGCCC
TGCCCCATTTTGGGTCATC -> GCCCCATTTTGGGTCATCC
CCAGATCGGACCTATGGCG -> CAGATCGGACCTATGGCGT
AGACAAATCACATTACTGA -> GACAAATCACATTACTGAG
ATTGTATGCCCCCGCAACC -> TTGTATGCCCCCGCAACCA
GAACGAGTGGGTGCAGGCA -> AACGAGTGGGTGCAGGCAC
CTTTATCATAAGCATAAAA -> TTTATCATAAGCATAAAAA
CAACACGGATGCCGCAGCG -> AACACGGATGCCGCAGCGA
TTTCTCAACGTACTTTATC -> TTCTCAACGTACTTTATCA
CCGCCCTGCTGTTCCGGGG -> CGCCCTGCTGTTCCGGGGA
ATGGCGTCTCAGTCTTAAA -> TGGCGTCTCAGTCTTAAAG
TACCCGGCTAGTTCCTTTT -> ACCCGGCTAGTTCCTTTTC
CTTACACGGGAAGCGCGTT -> TTACACGGGAAGCGCGTTA
TTTAGAGTCACTGGTTAGC -> TTAGAGTCACTGGTTAGCG
CATAGGAGGGAACCGGCTA -> ATAGGAGGGAACCGGCTAT
AGAACTAGTCCCCAGTGGA -> GAACTAGTCCCCAGTGGAT
TTCCATACGCAGTGGGGCG -> TCCATACGCAGTGGGGCGG
GTAGTGGCACACGTGGATG -> TAGTGGCACACGTGGATGA
CGTAGTTTTTAGACGACAC -> GTAGTTTTTAGACGACACA
CGCAGCGAGGTCATGCGAT -> GCAGCGAGGTCATGCGATC
CTTAACACGTGGATCGAGC -> TTAACACGTGGATCGAGCC
ACGCAGTGGGGCGGTATCT -> CGCAGTGGGGCGGTATCTA
CAGCTTGCCACTCGGTTCG -> AGCTTGCCACTCGGTTCGT
GTGCCAAACCCATAGAAGT -> TGCCAAACCCATAGAAGTG
CCGGGCGATGGCTCTGTCC -> CGGGCGATGGCTCTGTCCA
AATTGGAATGAAACCTCGT -> ATTGGAATGAAACCTCGTC
GATACCATTCGCCGCACTG -> ATACCATTCGCCGCACTGA
CTGTCTTCGAAAGACCGTA -> TGTCTTCGAAAGACCGTAA
GCCCCGGGTGTCGCGAACG -> CCCCGGGTGTCGCGAACGT
CGGGGATGTTGAGTCAGTG -> GGGGATGTTGAGTCAGTGC
ATACCTGAATTGGAATGAA -> TACCTGAATTGGAATGAAA
GTGTAGTGCGTAGTTTTTA -> TGTAGTGCGTAGTTTTTAG
TCTAGTGCGGCTCTCGTCG -> CTAGTGCGGCTCTCGTCGT
ACCTGAATGATGGTGTTAT -> CCTGAATGATGGTGTTATC
TCCAAAAAATACCCGGCTA -> CCAAAAAATACCCGGCTAG
GGTATGCCCTAGAAATATT -> GTATGCCCTAGAAATATTG
GAAGTCGGTAATCCACGCG -> AAGTCGGTAATCCACGCGT
GCAGATGCTAGCACGTACA -> CAGATGCTAGCACGTACAT
CGCCCCGGGTGTCGCGAAC -> GCCCCGGGTGTCGCGAACG
TGCGTTATTATTGACGAGT -> GCGTTATTATTGACGAGTC
GGATGAGCAAGAAAATGCA -> GATGAGCAAGAAAATGCAT
TGCACAAGGTCAGCGTGCC -> GCACAAGGTCAGCGTGCCA
ACTCGGTTCGTCGGTCATA -> CTCGGTTCGTCGGTCATAT
CATGCGCGTGGTGTGGGCT -> ATGCGCGTGGTGTGGGCTC
GGCACTATACCTGAATAAC -> GCACTATACCTGAATAACG
AAAGTTTAATGTTCCATAC -> AAGTTTAATGTTCCATACG
GGGGATCTGATTAGAGTGA -> GGGATCTGATTAGAGTGAC
GATCACGCGTAGACCAACG -> ATCACGCGTAGACCAACGG
AGACCGTAATATCTCGGAA -> GACCGTAATATCTCGGAAA
GCCACTAGGCGAACGCCCA -> CCACTAGGCGAACGCCCAG
ACGAGTGGGTGCAGGCACT -> CGAGTGGGTGCAGGCACTA
AAGGTCGCCGGGCGATGGC -> AGGTCGCCGGGCGATGGCT
CGGTAACGCGATAATGCCA -> GGTAACGCGATAATGCCAT
TTATCATAAGCATAAAAAC -> TATCATAAGCATAAAAACC
CCCAGTGGATACGCGAACG -> CCAGTGGATACGCGAACGG
GGTTTTCTCGTAGGAGGAA -> GTTTTCTCGTAGGAGGAAT
GTGATACCATTCGCCGCAC -> TGATACCATTCGCCGCACT
ATTCACTTTACCAGAACGC -> TTCACTTTACCAGAACGCA
ACAAATCACATTACTGAGA -> CAAATCACATTACTGAGAC
TGAGCCGGACCGGATCACG -> GAGCCGGACCGGATCACGC
GGTCGGCGGCACGCGGGGA -> GTCGGCGGCACGCGGGGAG
GAATTGGAATGAAACCTCG -> AATTGGAATGAAACCTCGT
TTTCTATCGCTGTTCGCCG -> TTCTATCGCTGTTCGCCGG
TCACATTACTGAGACGTGA -> CACATTACTGAGACGTGAT
AATCCGTATTGTACGCCTG -> ATCCGTATTGTACGCCTGC
GGGAAGCGCGTTAGTAGCA -> GGAAGCGCGTTAGTAGCAC
GAAGCGCGTTAGTAGCACA -> AAGCGCGTTAGTAGCACAG
CGTCGTTTCCCTCGATCAA -> GTCGTTTCCCTCGATCAAT
GGACCCTATCGAGAATGCC -> GACCCTATCGAGAATGCCG
TGTATGCCCCCGCAACCAT -> GTATGCCCCCGCAACCATA
TGACGCTGGTGTAAATCCG -> GACGCTGGTGTAAATCCGT
TGTGGGCTCGATGCGCAGC -> GTGGGCTCGATGCGCAGCG
GGGTGCAGGCACTATACCT -> GGTGCAGGCACTATACCTG
GGGCAGATGCTAGCACGTA -> GGCAGATGCTAGCACGTAC
CCCCGGGTGTCGCGAACGT -> CCCGGGTGTCGCGAACGTG
TACATAGGAGGGAACCGGC -> ACATAGGAGGGAACCGGCT
CTAGTGCGGCTCTCGTCGT -> TAGTGCGGCTCTCGTCGTG
GACAGAAGTGGAGTTGGGT -> ACAGAAGTGGAGTTGGGTA
CTCCCTCACTTCCGCAGTC -> TCCCTCACTTCCGCAGTCT
GATTTCTCCATGCTTACAC -> ATTTCTCCATGCTTACACG
CCGATACTCAATACCAGCC -> CGATACTCAATACCAGCCT
TCCCTTTGCGACAATTTGT -> CCCTTTGCGACAATTTGTG
AACACGCGCTGCGATGCCT -> ACACGCGCTGCGATGCCTA
TGGGCTCGATGCGCAGCGT -> GGGCTCGATGCGCAGCGTG
GTGGATCGAGCCTCAGGAT -> TGGATCGAGCCTCAGGATG
CGTCGGTCATATCGTCACA -> GTCGGTCATATCGTCACAC
AATATGCGGTTTTCTCGTA -> ATATGCGGTTTTCTCGTAG
CTGCGATGCCTAAGAATTA -> TGCGATGCCTAAGAATTAA
GACGTGATACCATTCGCCG -> ACGTGATACCATTCGCCGC
CTAGTTCCTTTTCTATCGC -> TAGTTCCTTTTCTATCGCT
TGTGTAGATCGGCGGTAAA -> GTGTAGATCGGCGGTAAAA
GGAAATCTCCCTCATCTAA -> GAAATCTCCCTCATCTAAC
TATCATAAGCATAAAAACC -> ATCATAAGCATAAAAACCC
GGAGGGAACCGGCTATTCG -> GAGGGAACCGGCTATTCGA
CAGCCTAATACGTTGGACC -> AGCCTAATACGTTGGACCC
GGCGATGGCTCTGTCCATC -> GCGATGGCTCTGTCCATCC
TTGCCCCATTTTGGGTCAT -> TGCCCCATTTTGGGTCATC
GCGTAGACCAACGGCTGAT -> CGTAGACCAACGGCTGATC
GCTATTCGAGTAGGTAGTG -> CTATTCGAGTAGGTAGTGA
GCCGGACCGGATCACGCGT -> CCGGACCGGATCACGCGTA
AATTGTATGCCCCCGCAAC -> ATTGTATGCCCCCGCAACC
CTATACCTGAATCTAGTGC -> TATACCTGAATCTAGTGCG
TGGATCGAGCCTCAGGATG -> GGATCGAGCCTCAGGATGC
GTAGCACAGAATAAGACCA -> TAGCACAGAATAAGACCAC
TAGTAGGCACAGGCACTAT -> AGTAGGCACAGGCACTATA
TTGCCTCGTTGAGCCGGAC -> TGCCTCGTTGAGCCGGACC
AATTTGTGACCAACACACT -> ATTTGTGACCAACACACTA
ACTAGTCCCCAGTGGATAC -> CTAGTCCCCAGTGGATACG
ACAATACGAATTACTTGGT -> CAATACGAATTACTTGGTC
CATAAGCATAAAAACCCTG -> ATAAGCATAAAAACCCTGT
ATGGGTAGGACCCCCTAGT -> TGGGTAGGACCCCCTAGTC
GTGAAGTCGGTAATCCACG -> TGAAGTCGGTAATCCACGC
CATCTAACTTTATCTGGAT -> ATCTAACTTTATCTGGATT
GCGTCTGACGCTGGTGTAA -> CGTCTGACGCTGGTGTAAA
CATCGATAGGATACGGGCA -> ATCGATAGGATACGGGCAG
TATTATTGACGAGTCCCAG -> ATTATTGACGAGTCCCAGG
GAGACGTGATACCATTCGC -> AGACGTGATACCATTCGCC
TTTGCCTCGTTGAGCCGGA -> TTGCCTCGTTGAGCCGGAC
ACTATACCTGAATTGGAAT -> CTATACCTGAATTGGAATG
CAGGCTGCTGGGCACTCGT -> AGGCTGCTGGGCACTCGTA
TATTCGAGTAGGTAGTGAT -> ATTCGAGTAGGTAGTGATG
CTTGTTAGCTTATCATAAG -> TTGTTAGCTTATCATAAGG
ATTAAGGTCGCCGGGCGAT -> TTAAGGTCGCCGGGCGATG
GTCGCCGGGCGATGGCTCT -> TCGCCGGGCGATGGCTCTG
CCCGGACTGGTCGTGGCGC -> CCGGACTGGTCGTGGCGCC
GCTCTGTCCATCCTTGGCT -> CTCTGTCCATCCTTGGCTA
CTCACTTCCGCAGTCTCAA -> TCACTTCCGCAGTCTCAAC
CCATTTTGGGTCATCCATT -> CATTTTGGGTCATCCATTG
ACACCGCCCTGCTGTTCCG -> CACCGCCCTGCTGTTCCGG
GGCTCTCGTCGTGGTGGGT -> GCTCTCGTCGTGGTGGGTG
TAGGAGGAATTGACCGAAC -> AGGAGGAATTGACCGAACT
CGGACCTATGGCGTCTCAG -> GGACCTATGGCGTCTCAGT
ATTTTAGAGTCACTGGTTA -> TTTTAGAGTCACTGGTTAG
AGCCTCCACTCATCGATAG -> GCCTCCACTCATCGATAGG
GATCGAGCCTCAGGATGCG -> ATCGAGCCTCAGGATGCGT
ATGCGCGTGGTGTGGGCTC -> TGCGCGTGGTGTGGGCTCG
ACGAATTACTTGGTCGGTT -> CGAATTACTTGGTCGGTTT
AGGAGGAATTGACCGAACT -> GGAGGAATTGACCGAACTG
ACGAAGCAGCGCGTCTGAC -> CGAAGCAGCGCGTCTGACG
ACGTCGTTTCCCTCGATCA -> CGTCGTTTCCCTCGATCAA
TCCGGGGATGTTGAGTCAG -> CCGGGGATGTTGAGTCAGT
CCAACGGCTGATCCGTTGT -> CAACGGCTGATCCGTTGTC
TGTTTCCCTTTGCGACAAT -> GTTTCCCTTTGCGACAATT
GTAGGCACAGGCACTATAC -> TAGGCACAGGCACTATACC
TTAGCGCTTCCGTTCCGTT -> TAGCGCTTCCGTTCCGTTT
ACTATACCTGAATCTAGTG -> CTATACCTGAATCTAGTGC
AGGATCACCAACCAGCTTG -> GGATCACCAACCAGCTTGC
AGCGCGTCTGACGCTGGTG -> GCGCGTCTGACGCTGGTGT
TGGGGCGGTATCTAAGCGA -> GGGGCGGTATCTAAGCGAA
AGCGACTGCCGACAATACG -> GCGACTGCCGACAATACGA
CCATACGCAGTGGGGCGGT -> CATACGCAGTGGGGCGGTA
AGTGCGGCTCTCGTCGTGG -> GTGCGGCTCTCGTCGTGGT
GCACTATACCTGAATGATG -> CACTATACCTGAATGATGG
CTGTTCGCCGGTCTTGCAC -> TGTTCGCCGGTCTTGCACA
TGGAGTTGGGTAGAAGCTA -> GGAGTTGGGTAGAAGCTAT
AAATACCCGGCTAGTTCCT -> AATACCCGGCTAGTTCCTT
TTGTGACCAACACACTAGT -> TGTGACCAACACACTAGTA
CGTCGTGGTGGGTGTAGTG -> GTCGTGGTGGGTGTAGTGC,GTCGTGGTGGGTGTAGTGG
TACCGGATATCTTACACAT -> ACCGGATATCTTACACATC
GCGCGTCTGACGCTGGTGT -> CGCGTCTGACGCTGGTGTA
AACGATTGTATGGGATGGT -> ACGATTGTATGGGATGGTA
ATTCGAGTAGGTAGTGATG -> TTCGAGTAGGTAGTGATGA
AGTAGGTAGTGATGACTTG -> GTAGGTAGTGATGACTTGT
TGAACTCGTGTGCGTTATT -> GAACTCGTGTGCGTTATTA
AATACGAATTACTTGGTCG -> ATACGAATTACTTGGTCGG
GAGTAGGTAGTGATGACTT -> AGTAGGTAGTGATGACTTG
TCGAAAGACCGTAATATCT -> CGAAAGACCGTAATATCTC
ATGAACTCGTGTGCGTTAT -> TGAACTCGTGTGCGTTATT
GAAGGATCACCAACCAGCT -> AAGGATCACCAACCAGCTT
GTGCAGGCACTATACCTGA -> TGCAGGCACTATACCTGAA
CCTGAATAACGGCCCATTC -> CTGAATAACGGCCCATTCT
TCGTGGCGCCCCGGGTGTC -> CGTGGCGCCCCGGGTGTCG
ACACGTGGATGACTATCTG -> CACGTGGATGACTATCTGT
TCACGCGAACGGGTCACTG -> CACGCGAACGGGTCACTGA
TGAAGTCGGTAATCCACGC -> GAAGTCGGTAATCCACGCG
GTGTTATCTCGTCGTGGTG -> TGTTATCTCGTCGTGGTGG
TCGCCGGGCGATGGCTCTG -> CGCCGGGCGATGGCTCTGT
GTGGCACACGTGGATGACT -> TGGCACACGTGGATGACTA
TATCTGAGCCTCCACTCAT -> ATCTGAGCCTCCACTCATC
TCGTTGGACTCTTATGCAG -> CGTTGGACTCTTATGCAGC
CCATAGGCTCCAGAACACG -> CATAGGCTCCAGAACACGC
TGGTAAAGTTTAATGTTCC -> GGTAAAGTTTAATGTTCCA
CAAATCACATTACTGAGAC -> AAATCACATTACTGAGACG
GGTAATCCACGCGTCGCCA -> GTAATCCACGCGTCGCCAT
CGCCGGTCTTGCACAAGGT -> GCCGGTCTTGCACAAGGTC
GGCTACGAAGCAGCGCGTC -> GCTACGAAGCAGCGCGTCT
ACCTGAATTGGAATGAAAC -> CCTGAATTGGAATGAAACC
CCTGCTGTTCCGGGGATGT -> CTGCTGTTCCGGGGATGTT
CGGTTTCGTGCCAAACCCA -> GGTTTCGTGCCAAACCCAT
GGCAGATGCTAGCACGTAC -> GCAGATGCTAGCACGTACA
ATTGGAATGAAACCTCGTC -> TTGGAATGAAACCTCGTCG
AGTTGGGTAGAAGCTATTC -> GTTGGGTAGAAGCTATTCC
AATTGACCGAACTGTTTCC -> ATTGACCGAACTGTTTCCC
ATAAGCATAAAAACCCTGT -> TAAGCATAAAAACCCTGTG
GGATATCTTACACATCAGG -> GATATCTTACACATCAGGC
CAGCGAGGTCATGCGATCC -> AGCGAGGTCATGCGATCCC
CTAGTGCCAGTGCCCAGAT -> TAGTGCCAGTGCCCAGATC
ACCGAACTGTTTCCCTTTG -> CCGAACTGTTTCCCTTTGC
GGGCACTCGTAGCCCTGGA -> GGCACTCGTAGCCCTGGAA
TTCGTGCCAAACCCATAGA -> TCGTGCCAAACCCATAGAA
TAACGCGATAATGCCATTT -> AACGCGATAATGCCATTTT
CGAGAATGCCGCTCTTGTG -> GAGAATGCCGCTCTTGTGG
CTTGTACTACCGGATATCT -> TTGTACTACCGGATATCTT
TGCCGACAATACGAATTAC -> GCCGACAATACGAATTACT
CTATATGGGTAGGACCCCC -> TATATGGGTAGGACCCCCT
TGGCGCCCCGGGTGTCGCG -> GGCGCCCCGGGTGTCGCGA
TATATAATCCCTCCCTCAC -> ATATAATCCCTCCCTCACT
GGGATGGTAAAGTTTAATG -> GGATGGTAAAGTTTAATGT
GGAACCGATACTCAATACC -> GAACCGATACTCAATACCA
CAACGTACTTTATCATAAG -> AACGTACTTTATCATAAGC
AGTGCCCAGATCGGACCTA -> GTGCCCAGATCGGACCTAT
ACCTATGGCGTCTCAGTCT -> CCTATGGCGTCTCAGTCTT
CGAACGAGTGGGTGCAGGC -> GAACGAGTGGGTGCAGGCA
TCATACCGAGACAAATCAC -> CATACCGAGACAAATCACA
ATTCAATTATATTCTGCTC -> TTCAATTATATTCTGCTCT
ATAGGATACGGGCAGATGC -> TAGGATACGGGCAGATGCT
GTGTACCAACCGAAAGCAC -> TGTACCAACCGAAAGCACA
GACCAACACACTAGTAGGC -> ACCAACACACTAGTAGGCA
CCTCCCTCACTTCCGCAGT -> CTCCCTCACTTCCGCAGTC
CTATCTGTGTACCAACCGA -> TATCTGTGTACCAACCGAA
GTCACACCGCCCTGCTGTT -> TCACACCGCCCTGCTGTTC
GATGGTAAAGTTTAATGTT -> ATGGTAAAGTTTAATGTTC
CCGCACTGATACGTGAAGG -> CGCACTGATACGTGAAGGA
AAAATACCCGGCTAGTTCC -> AAATACCCGGCTAGTTCCT
ATAAAAACCCTGTGTGAAG -> TAAAAACCCTGTGTGAAGT
AGTGCGTGATTGGCAGACG -> GTGCGTGATTGGCAGACGT
CGATGCGCAGCGTGGCTTT -> GATGCGCAGCGTGGCTTTC
GACTTTGGCTCACGCGAAC -> ACTTTGGCTCACGCGAACG
GAATCCAGTATCTGAGCCT -> AATCCAGTATCTGAGCCTC
TCCTTTTCTATCGCTGTTC -> CCTTTTCTATCGCTGTTCG
CGCGTCGCCATGTTGCATT -> GCGTCGCCATGTTGCATTG
GTAAAATGAACTCGTGTGC -> TAAAATGAACTCGTGTGCG
CAGTGGGGCGGTATCTAAG -> AGTGGGGCGGTATCTAAGC
TGCGATGCCTAAGAATTAA -> GCGATGCCTAAGAATTAAC
TAAACTCTCTAGCGACTGC -> AAACTCTCTAGCGACTGCC
TAATGTTCCATACGCAGTG -> AATGTTCCATACGCAGTGG
GGTTAATACCGTAAACTCT -> GTTAATACCGTAAACTCTC
ACGTGGATCGAGCCTCAGG -> CGTGGATCGAGCCTCAGGA
TCGATAGGATACGGGCAGA -> CGATAGGATACGGGCAGAT
CGCAACCATACGTCGTTTC -> GCAACCATACGTCGTTTCC
GGGGCGGGTCAATCAGCAC -> GGGCGGGTCAATCAGCACG
AGTTCCTTTTCTATCGCTG -> GTTCCTTTTCTATCGCTGT
GATGCGCAGCGTGGCTTTC -> ATGCGCAGCGTGGCTTTCT
CGTTGGACTCTTATGCAGC -> GTTGGACTCTTATGCAGCT
TCTCGTCGTGGTGGGTGTA -> CTCGTCGTGGTGGGTGTAG,CTCGTCGTGGTGGGTGTAG,CTCGTCGTGGTGGGTGTAG
CGGCGGCACGCGGGGAGCG -> GGCGGCACGCGGGGAGCGT
TGAGCAAGAAAATGCATTA -> GAGCAAGAAAATGCATTAA
TCGCCATGTTGCATTGGTT -> CGCCATGTTGCATTGGTTA
CCCATAGAAGTGGATTGCG -> CCATAGAAGTGGATTGCGG
GGCCCATTCTCGTCGTGGT -> GCCCATTCTCGTCGTGGTG
CTTGGCTACGAAGCAGCGC -> TTGGCTACGAAGCAGCGCG
GCAAGAAAATGCATTAAGG -> CAAGAAAATGCATTAAGGT
CGAGACAAATCACATTACT -> GAGACAAATCACATTACTG
TGCGGTTTTCTCGTAGGAG -> GCGGTTTTCTCGTAGGAGG
AGCAAGAAAATGCATTAAG -> GCAAGAAAATGCATTAAGG
AAGTTTAATGTTCCATACG -> AGTTTAATGTTCCATACGC
TTGATTCTAGTGCCAGTGC -> TGATTCTAGTGCCAGTGCC
GGTGTCGCGAACGTGGAGA -> GTGTCGCGAACGTGGAGAA
GATTGCGGATGAGCAAGAA -> ATTGCGGATGAGCAAGAAA
CTAGAAATATTGATTCTAG -> TAGAAATATTGATTCTAGT
CTCGTTGAGCCGGACCGGA -> TCGTTGAGCCGGACCGGAT
AATGCATTAAGGTCGCCGG -> ATGCATTAAGGTCGCCGGG
TTCTCGTAGGAGGAATTGA -> TCTCGTAGGAGGAATTGAC
ATGACTATCTGTGTACCAA -> TGACTATCTGTGTACCAAC
CAGATCGGACCTATGGCGT -> AGATCGGACCTATGGCGTC
CTAACTTTATCTGGATTTC -> TAACTTTATCTGGATTTCT
CCTGCGTTACTGCAGTAGC -> CTGCGTTACTGCAGTAGCA
GCGTTATTATTGACGAGTC -> CGTTATTATTGACGAGTCC
ACCCATAGAAGTGGATTGC -> CCCATAGAAGTGGATTGCG
CGATAGGATACGGGCAGAT -> GATAGGATACGGGCAGATG
TCTAGAACTAGTCCCCAGT -> CTAGAACTAGTCCCCAGTG
TATACCTGAATCTAGTGCG -> ATACCTGAATCTAGTGCGG
TAATATCTCGGAAATCTCC -> AATATCTCGGAAATCTCCC
TTACGGTAACGCGATAATG -> TACGGTAACGCGATAATGC
CCTCCACTCATCGATAGGA -> CTCCACTCATCGATAGGAT
GCACAGAATAAGACCACTC -> CACAGAATAAGACCACTCA
GGGTGTAGTGGCACACGTG -> GGTGTAGTGGCACACGTGG
GTTATAGAAACGGTAGCAC -> TTATAGAAACGGTAGCACG
GGATCGAGCCTCAGGATGC -> GATCGAGCCTCAGGATGCG
TGGGAGCATCAGGAGGGGC -> GGGAGCATCAGGAGGGGCG
AATTAACGGGGATCTGATT -> ATTAACGGGGATCTGATTA
AAGGAGTCCACTCATACCG -> AGGAGTCCACTCATACCGA
CACGTGGATCGAGCCTCAG -> ACGTGGATCGAGCCTCAGG
CGAGCTTAACACGTGGATC -> GAGCTTAACACGTGGATCG
CGAGTAGGTAGTGATGACT -> GAGTAGGTAGTGATGACTT
ACTCCAGGCTGCTGGGCAC -> CTCCAGGCTGCTGGGCACT
AGCGTGCCACTAGGCGAAC -> GCGTGCCACTAGGCGAACG
AAAGCCTAATGGGTCGCCA -> AAGCCTAATGGGTCGCCAA
GGCACACGTGGATGACTAT -> GCACACGTGGATGACTATC
ACTCGTGTGCGTTATTATT -> CTCGTGTGCGTTATTATTG
ACTCATACCGAGACAAATC -> CTCATACCGAGACAAATCA
ACGTCCGGTATGCCCTAGA -> CGTCCGGTATGCCCTAGAA
TTTCGAATTGTATGCCCCC -> TTCGAATTGTATGCCCCCG
GAACCGGCTATTCGAGTAG -> AACCGGCTATTCGAGTAGG
GATTCTAGTGCCAGTGCCC -> ATTCTAGTGCCAGTGCCCA
CGCGAACGTGGAGAATCCA -> GCGAACGTGGAGAATCCAG
GGTAGGACCCCCTAGTCTC -> GTAGGACCCCCTAGTCTCA
GGTTTCGTGCCAAACCCAT -> GTTTCGTGCCAAACCCATA
ATGTTGAGTCAGTGCGTGA -> TGTTGAGTCAGTGCGTGAT
GGTAACGCGATAATGCCAT -> GTAACGCGATAATGCCATT
AGTGGGTGCAGGCACTATA -> GTGGGTGCAGGCACTATAC
TTATGCAGCTTTGCCCCAT -> TATGCAGCTTTGCCCCATT
GAGTCCACTCATACCGAGA -> AGTCCACTCATACCGAGAC
AATGGGAGCATCAGGAGGG -> ATGGGAGCATCAGGAGGGG
ATCTGTGTACCAACCGAAA -> TCTGTGTACCAACCGAAAG
GGTCAATCAGCACGTCTCG -> GTCAATCAGCACGTCTCGC
GCTTCCGTTCCGTTTCAGC -> CTTCCGTTCCGTTTCAGCC
TGTGTACCAACCGAAAGCA -> GTGTACCAACCGAAAGCAC
AACCCTGTGTGAAGTCGGT -> ACCCTGTGTGAAGTCGGTA
GTCGGTAATCCACGCGTCG -> TCGGTAATCCACGCGTCGC
ATCGGCGGTAAAATGAACT -> TCGGCGGTAAAATGAACTC
ACTTCCGCAGTCTCAACTT -> CTTCCGCAGTCTCAACTTG
AATCCACGCGTCGCCATGT -> ATCCACGCGTCGCCATGTT
TGGCGTCTCAGTCTTAAAG -> GGCGTCTCAGTCTTAAAGC
AGTCACTGGTTAGCGCTTC -> GTCACTGGTTAGCGCTTCC
GAGTGACTTTGGCTCACGC -> AGTGACTTTGGCTCACGCG
TAGCACGAGACAGAAGTGG -> AGCACGAGACAGAAGTGGA
CGGGTCAATCAGCACGTCT -> GGGTCAATCAGCACGTCTC
TCTAAGCGAACGAGTGGGT -> CTAAGCGAACGAGTGGGTG
GAAGCTATTCCATAGGCTC -> AAGCTATTCCATAGGCTCC
TAGTCTCACTTGTTAGCTT -> AGTCTCACTTGTTAGCTTA
GTAAAGTTTAATGTTCCAT -> TAAAGTTTAATGTTCCATA
TAGGCACAGGCACTATACC -> AGGCACAGGCACTATACCT
AGTCTACTGTCTTCGAAAG -> GTCTACTGTCTTCGAAAGA
TGCGTTACTGCAGTAGCAT -> GCGTTACTGCAGTAGCATT
TCGATGCGCAGCGTGGCTT -> CGATGCGCAGCGTGGCTTT
ATACGGGCAGATGCTAGCA -> TACGGGCAGATGCTAGCAC
TGGACTTTCGAATTGTATG -> GGACTTTCGAATTGTATGC
CGTGGTGGGTGTAGTGGCA -> GTGGTGGGTGTAGTGGCAC
ATAAGGAGTCCACTCATAC -> TAAGGAGTCCACTCATACC
GGGATGTTGAGTCAGTGCG -> GGATGTTGAGTCAGTGCGT
ATTCCATAGGCTCCAGAAC -> TTCCATAGGCTCCAGAACA
CGGGTTAATACCGTAAACT -> GGGTTAATACCGTAAACTC
AGGAGGGAACCGGCTATTC -> GGAGGGAACCGGCTATTCG
ACACGGATGCCGCAGCGAG -> CACGGATGCCGCAGCGAGG
CATACGTCGTTTCCCTCGA -> ATACGTCGTTTCCCTCGAT
GCTTACACGGGAAGCGCGT -> CTTACACGGGAAGCGCGTT
TGTACTACCGGATATCTTA -> GTACTACCGGATATCTTAC
AGTAGGCACAGGCACTATA -> GTAGGCACAGGCACTATAC
TCCACTCATCGATAGGATA -> CCACTCATCGATAGGATAC
TCCCATATACATAGGAGGG -> CCCATATACATAGGAGGGA
ATACGAATTACTTGGTCGG -> TACGAATTACTTGGTCGGT
GAGTGGGTGCAGGCACTAT -> AGTGGGTGCAGGCACTATA
TTGGCTCACGCGAACGGGT -> TGGCTCACGCGAACGGGTC
TATGCAGCTTTGCCCCATT -> ATGCAGCTTTGCCCCATTT
CTCCAGAACACGCGCTGCG -> TCCAGAACACGCGCTGCGA
GAACCGATACTCAATACCA -> AACCGATACTCAATACCAG
GTCATATCGTCACACCGCC -> TCATATCGTCACACCGCCC
CATCCAAAAAATACCCGGC -> ATCCAAAAAATACCCGGCT
GTAGCGCTGCCATCCCATA -> TAGCGCTGCCATCCCATAT
TATACCTGAATAACGGCCC -> ATACCTGAATAACGGCCCA
TTTGGGTGGGCTTTGCCTC -> TTGGGTGGGCTTTGCCTCG
CCCTCCCTCACTTCCGCAG -> CCTCCCTCACTTCCGCAGT
GTCTCACTTGTTAGCTTAT -> TCTCACTTGTTAGCTTATC
GTGTAGCGCTGCCATCCCA -> TGTAGCGCTGCCATCCCAT
ATCTAGTGCGGCTCTCGTC -> TCTAGTGCGGCTCTCGTCG
CTGAATCTAGTGCGGCTCT -> TGAATCTAGTGCGGCTCTC
TGATACCATTCGCCGCACT -> GATACCATTCGCCGCACTG
CACGCGTCGCCATGTTGCA -> ACGCGTCGCCATGTTGCAT
AAGTCGGTAATCCACGCGT -> AGTCGGTAATCCACGCGTC
CCCTGTGTGAAGTCGGTAA -> CCTGTGTGAAGTCGGTAAT
GGTGGGTGTAGTGCGTAGT -> GTGGGTGTAGTGCGTAGTT
CTTTACCAGAACGCACGTC -> TTTACCAGAACGCACGTCG
CGCACATTCAATTATATTC -> GCACATTCAATTATATTCT
ATCATAAGGAGTCCACTCA -> TCATAAGGAGTCCACTCAT
GTGTGAAGTCGGTAATCCA -> TGTGAAGTCGGTAATCCAC
AAAAAATACCCGGCTAGTT -> AAAAATACCCGGCTAGTTC
AACTTGACGAGCTTAACAC -> ACTTGACGAGCTTAACACG
GCAGCGAGGTCATGCGATC -> CAGCGAGGTCATGCGATCC
CCAAAAAATACCCGGCTAG -> CAAAAAATACCCGGCTAGT
TAGCGCTGCCATCCCATAT -> AGCGCTGCCATCCCATATA
GCCCCATTTTGGGTCATCC -> CCCCATTTTGGGTCATCCA
GCCATCCCATATACATAGG -> CCATCCCATATACATAGGA
GGTGGGTGTAGCGCTGCCA -> GTGGGTGTAGCGCTGCCAT
CTGAATGATGGTGTTATCT -> TGAATGATGGTGTTATCTC
GCTCGATGCGCAGCGTGGC -> CTCGATGCGCAGCGTGGCT
CTCCACTCATCGATAGGAT -> TCCACTCATCGATAGGATA
GTGGAGAATCCAGTATCTG -> TGGAGAATCCAGTATCTGA
GCGAACGTGGAGAATCCAG -> CGAACGTGGAGAATCCAGT
ATACCAGCCTAATACGTTG -> TACCAGCCTAATACGTTGG
GAGTCAGTGCGTGATTGGC -> AGTCAGTGCGTGATTGGCA
TTGCGGATGAGCAAGAAAA -> TGCGGATGAGCAAGAAAAT
AACTTTATCTGGATTTCTC -> ACTTTATCTGGATTTCTCC
CCATGCTTACACGGGAAGC -> CATGCTTACACGGGAAGCG
TCACTGGTTAGCGCTTCCG -> CACTGGTTAGCGCTTCCGT
TAACACGTGGATCGAGCCT -> AACACGTGGATCGAGCCTC
GAATTACTTGGTCGGTTTC -> AATTACTTGGTCGGTTTCG
CCATTGGACTTTCGAATTG -> CATTGGACTTTCGAATTGT
CACTGAATTTTTGTGTAGA -> ACTGAATTTTTGTGTAGAT
AGATCGGCGGTAAAATGAA -> GATCGGCGGTAAAATGAAC
CTCTCTAGCGACTGCCGAC -> TCTCTAGCGACTGCCGACA
CACTATACCTGAATGATGG -> ACTATACCTGAATGATGGT
GGGCGGTATCTAAGCGAAC -> GGCGGTATCTAAGCGAACG
GCTTTGCCTCGTTGAGCCG -> CTTTGCCTCGTTGAGCCGG
GTGCCCAGATCGGACCTAT -> TGCCCAGATCGGACCTATG
ATCTAAGCGAACGAGTGGG -> TCTAAGCGAACGAGTGGGT
CTGCCATCCCATATACATA -> TGCCATCCCATATACATAG
CGGCACGCGGGGAGCGTAG -> GGCACGCGGGGAGCGTAGT
TAAGCATAAAAACCCTGTG -> AAGCATAAAAACCCTGTGT
TCAACTTGACGAGCTTAAC -> CAACTTGACGAGCTTAACA
AGACCAACGGCTGATCCGT -> GACCAACGGCTGATCCGTT
AGGAGGGGCGGGTCAATCA -> GGAGGGGCGGGTCAATCAG
GCGCGTTAGTAGCACAGAA -> CGCGTTAGTAGCACAGAAT
CCATCCTTGGCTACGAAGC -> CATCCTTGGCTACGAAGCA
GAATGGGAGCATCAGGAGG -> AATGGGAGCATCAGGAGGG
CTGCTGGGCACTCGTAGCC -> TGCTGGGCACTCGTAGCCC
ATGCGGTTTTCTCGTAGGA -> TGCGGTTTTCTCGTAGGAG
AAGAAAATGCATTAAGGTC -> AGAAAATGCATTAAGGTCG
TTTTCTCGTAGGAGGAATT -> TTTCTCGTAGGAGGAATTG
ACACAACACGGATGCCGCA -> CACAACACGGATGCCGCAG
GACACACAACACGGATGCC -> ACACACAACACGGATGCCG
ACGTCTCGCGTTTTTTATA -> CGTCTCGCGTTTTTTATAT
TTCGAATTGTATGCCCCCG -> TCGAATTGTATGCCCCCGC
TATGCCCTAGAAATATTGA -> ATGCCCTAGAAATATTGAT
TCTTAAAGCCTAATGGGTC -> CTTAAAGCCTAATGGGTCG
GACCAACGGCTGATCCGTT -> ACCAACGGCTGATCCGTTG
CCCCGCAACCATACGTCGT -> CCCGCAACCATACGTCGTT
ACCGAGACAAATCACATTA -> CCGAGACAAATCACATTAC
GCTTTGCCCCATTTTGGGT -> CTTTGCCCCATTTTGGGTC
GATCGGACCTATGGCGTCT -> ATCGGACCTATGGCGTCTC
TGCGTAGTTTTTAGACGAC -> GCGTAGTTTTTAGACGACA
GGTCATATCGTCACACCGC -> GTCATATCGTCACACCGCC
GATACGTGAAGGATCACCA -> ATACGTGAAGGATCACCAA
GGTCGCCGGGCGATGGCTC -> GTCGCCGGGCGATGGCTCT
GTGGGCTTTGCCTCGTTGA -> TGGGCTTTGCCTCGTTGAG
GAAAGCACATCCACGGAGA -> AAAGCACATCCACGGAGAT
ATAAGACCACTCATAATAT -> TAAGACCACTCATAATATG
GCTGTTCGCCGGTCTTGCA -> CTGTTCGCCGGTCTTGCAC
TACCGAGACAAATCACATT -> ACCGAGACAAATCACATTA
TTTGCCCCATTTTGGGTCA -> TTGCCCCATTTTGGGTCAT
CGGGCAGATGCTAGCACGT -> GGGCAGATGCTAGCACGTA
GTCTCCCACTCCAGGCTGC -> TCTCCCACTCCAGGCTGCT
TATGGCGTCTCAGTCTTAA -> ATGGCGTCTCAGTCTTAAA
TTCCTTTTCTATCGCTGTT -> TCCTTTTCTATCGCTGTTC
TTCGAGTAGGTAGTGATGA -> TCGAGTAGGTAGTGATGAC
CACGGGAAGCGCGTTAGTA -> ACGGGAAGCGCGTTAGTAG
TACGAAGCAGCGCGTCTGA -> ACGAAGCAGCGCGTCTGAC
TTTGGCTCACGCGAACGGG -> TTGGCTCACGCGAACGGGT
AGCTTATCATAAGGAGTCC -> GCTTATCATAAGGAGTCCA
TTTGGGTCATCCATTGGAC -> TTGGGTCATCCATTGGACT
AACGTGGAGAATCCAGTAT -> ACGTGGAGAATCCAGTATC
GCTCTAGAACTAGTCCCCA -> CTCTAGAACTAGTCCCCAG
AGCCTAATACGTTGGACCC -> GCCTAATACGTTGGACCCT
CTCAACGTACTTTATCATA -> TCAACGTACTTTATCATAA
CGCGCTGCGATGCCTAAGA -> GCGCTGCGATGCCTAAGAA
GACTCTTATGCAGCTTTGC -> ACTCTTATGCAGCTTTGCC
TGGCTTTCTCAACGTACTT -> GGCTTTCTCAACGTACTTT
TTTATCATAAGCATAAAAA -> TTATCATAAGCATAAAAAC
TTGGGTGGGCTTTGCCTCG -> TGGGTGGGCTTTGCCTCGT
TGTTGCATTGGTTATAGAA -> GTTGCATTGGTTATAGAAA
AATTACTTGGTCGGTTTCG -> ATTACTTGGTCGGTTTCGT
TAACGGGGATCTGATTAGA -> AACGGGGATCTGATTAGAG
CTTGGTCGGTTTCGTGCCA -> TTGGTCGGTTTCGTGCCAA
ACGCGAACGGGTTAATACC -> CGCGAACGGGTTAATACCG
TACCAGAACGCACGTCGCA -> ACCAGAACGCACGTCGCAC
CCCTCATCTAACTTTATCT -> CCTCATCTAACTTTATCTG
CACCAACCAGCTTGCCACT -> ACCAACCAGCTTGCCACTC
GATCCCGGACTGGTCGTGG -> ATCCCGGACTGGTCGTGGC
TAATGGGTCGCCAACGATT -> AATGGGTCGCCAACGATTG
AACCAGCTTGCCACTCGGT -> ACCAGCTTGCCACTCGGTT
TATTACGGTAACGCGATAA -> ATTACGGTAACGCGATAAT
CTCAGTCTTAAAGCCTAAT -> TCAGTCTTAAAGCCTAATG
CGCCTGCTATATGGGTAGG -> GCCTGCTATATGGGTAGGA
GCCCTGGAACCGATACTCA -> CCCTGGAACCGATACTCAA
TAGAAGCTATTCCATAGGC -> AGAAGCTATTCCATAGGCT
CGCACGTCGCACATTCAAT -> GCACGTCGCACATTCAATT
GTAGCACGAGACAGAAGTG -> TAGCACGAGACAGAAGTGG
CGTACTTTATCATAAGCAT -> GTACTTTATCATAAGCATA
GGTGGGTGTAGACTGCGCA -> GTGGGTGTAGACTGCGCAT
TAGTCCCCAGTGGATACGC -> AGTCCCCAGTGGATACGCG
GCGATGCCTAAGAATTAAC -> CGATGCCTAAGAATTAACG
GCTAGCACGTACATGCGCG -> CTAGCACGTACATGCGCGT
ACGAGACAGAAGTGGAGTT -> CGAGACAGAAGTGGAGTTG
TAGAGTCACTGGTTAGCGC -> AGAGTCACTGGTTAGCGCT
CGTCGCACATTCAATTATA -> GTCGCACATTCAATTATAT
TACCATTCGCCGCACTGAT -> ACCATTCGCCGCACTGATA
GTGGTGGGTGTAGACTGCG -> TGGTGGGTGTAGACTGCGC
CCACTCATAATATGCGGTT -> CACTCATAATATGCGGTTT
ATGCGATCCCGGACTGGTC -> TGCGATCCCGGACTGGTCG
CGAGACAGAAGTGGAGTTG -> GAGACAGAAGTGGAGTTGG
GGTGTAGACTGCGCATTTA -> GTGTAGACTGCGCATTTAT
CATATCGTCACACCGCCCT -> ATATCGTCACACCGCCCTG
GTGGCGCCCCGGGTGTCGC -> TGGCGCCCCGGGTGTCGCG

